ehstaˀ	‘she uses; people use’	[e-hst-haˀ]	she/someone.a-use-habitual
ganǫhsa̲ˀsǫ́:ˀah	'houses'	[ga-nǫhs-a̲ˀ-sǫ:ˀah]	it.a-house-noun.stem.former-pluralizer
dewage̲hęna̲ˀtraˀehsdǫ́hǫgyeˀ	'I am going along stabbing things'	[de-wage-hęnaˀtra-ˀe-hsd-ǫh-ǫgyeˀ]	dualic-I.a-knife-hit-cause.to-stative.progressive
hohsę:	‘When he was young, he was fat.’	[tsi-h-ǫgwe̲ˀd-a:sé:]	coincident-he.a-person-new.stative
hǫgwéˀdase:	‘young man’	[h-ǫgwéˀd-ase:]	he.a-person-new.stative
tsiyeksa̲ˀdá:se:	'when she was a teenager…’	[tsi-ye-ksa̲ˀd-á:se:]	coincident-she.a-child-new.stative
eksaˀdasé:ˀah	‘teenage girl’	[e-ksaˀd-asé:-ˀah]	she.a-child-new.stative-diminutive
sadahǫ́:dǫ:	‘(you) ask!’	[s-ad-ahǫ́:dǫ:]	you(one).a-semireflexive-ask-no.aspect
ęsada̲hǫ́:dǫ:ˀ	‘you will ask’	[ę-s-ad-a̲hǫ́:dǫ:-ˀ]	future-you(one).a-semireflexive-ask-punctual
aˀéganyaˀk	‘she paid’	[aˀ-e-ganyaˀg-ø]	factual-she.a-pay-ø.punctual
gagánya̲ˀgǫh	‘payment’	[ga-ga-nya̲ˀg-ǫh]	it.a-price-pay-stative
hękrih	‘I will pour’	[h-ę-k-hrih-ø]	translocative-future-I.a-pour-ø-punctual
gahíhǫh	‘it is spilled’	[ga-hríh-ǫh]	it.a-spill-stative
akní:nǫˀ	‘I did buy it’	[a-k-hní:nǫ-ˀ]	factual-I.a-buy-punctual
hadó:wa:s	'he is a hunter'	[h-adó:wa:t-s]	he.a-hunt-habitual
ęha:dó:wa:t	'he will hunt'	[ę-h-a:dó:wa:t-ø]	future-he.a-hunt-ø.punctual
gi̲hsa:s	'I am looking for it'	[g-i̲hsa:k-s]	I.a-look.for-habitual
ęgíhsa:k	'I will look for it'	[ę-g-íhsa:k-ø]	future-I.a-look-ø.punctual
gadinǫ̲hweˀs	‘they (animals) like it’	[gadi-nǫ̲hwe-ˀs]	they.animals-like-habitual
hęgiˀdrǫ́:daˀk	'where I will live'	[h-ę-g-iˀdrǫ́:-d-aˀk]	translocative-future-I.a-live-causative-modalizer
ehé:yǫhs	'she is dying, on her death bed'	[e-ihey-ǫhs]	she.a-die-habitual
gi̲hé:yǫhs	'I am dying'	[g-ihey-ǫhs]	I.a-die-habitual
egeˀahsrǫni:ˀ	‘she is a hairdresser’	[e-geˀa-hsrǫ́:ni-h]	she.a-hair-fix-habitual
gi̲hé:yǫhs	'I am dying'	[g-ihé:y-ǫhs]	I.a-die-habitual
hanǫhsǫ:nih	‘he is a carpenter’	[ha-nǫhs-ǫ́:ni-h]	he.a-house-build-habitual
dǫdáęˀ	'she is coming back'	[dǫdá-e-e-ˀ]	dualic.factual.cislocative-she.a-go-punctual
dǫdá:geˀ	'I am coming back'	[dǫdá:-g-e-ˀ]	dualic.factual.cislocative-I.a-go-punctual
ętgáęˀ	'they (f / m) will come'	[ę-t-gáe-e-ˀ]	future-cislocative-they(females)-go-punctual
ęteˀ	'he will come this way'	[ę-t-h-e-ˀ]	future-cislocative-he.a-go-punctual
í:yę:	'she wants'	[í:-ye-e-:]	prothetic-she.a-want-stative
ihse:	'you want'	[i-hs-e-:]	prothetic-you(one).a-want-stative
gǫ́:yǫˀ	‘I will give you’	[gǫ́:-y-ǫ-ˀ]	I:you-Y-give-punctual
ęhswá:yǫˀ	‘you will give it’	[ę-hswá:-y-ǫ-ˀ]	future-you(all).a-Y-give-punctual
hęnéhehk	'they (males) were thinking'	[hęn-é-he-hk]	they(males).a-think-habitual-former
hadíˀnhahgyaˀs	‘loggers’	[hadí-ˀnhahg-yaˀk-s]	they(males).a-log-cut-habitual
honé:ˀǫ:	'they (males) have willed, decided it'	[hon-é:ˀ-ǫ:]	they(males).o-will-stative
hodí:yęˀ	‘they (m) have’; ‘they have lain’	[hodí:-yę-ˀ]	they(males).o-lie-stative
gáęnaˀ	‘song’	[gá-ęn-aˀ]	it.a-song-nsf
shǫgwaęnáwi̲hshǫˀ	‘he has given us songs’	[shǫgwa-ęn-áwi̲h-shǫˀ]	he:us-song-give-pluralizer.stative
shehó:wih	‘tell her’	[she-hró:wi-h]	you:her-tell-pronunciation.h
ęga:thró:wiˀ	‘I will tell’	[ę-g-a:t-hró:wi-ˀ]	future-I.a-semireflexive-tell-punctual
ęgákhyadǫ:ˀ	‘I will have a reading’	[ę-g-ák-hyadǫ-:ˀ]	future-I.a-semireflexive-write-punctual
ęgáthyadǫ:ˀ	‘I will have a reading’	[ę-g-át-hyadǫ-:ˀ]	future-I.a-semireflexive-write-punctual
gyodóˀkda̲ˀǫh	‘it is lacking’	[g-yo-d-óˀkd-a̲-ˀǫh]	cislocative-it.o-semireflexive-end-joinerA-stative
dawádo̲ˀkdęˀ	‘it lacked’; ‘it was not enough’	[d-a-w-ád-o̲ˀkd-ęˀ]	cislocative-factual-it.a-semireflexive-end-punctual
ga̲ˀdrehdagwé:gǫh	‘all the cars’	[ga̲-ˀdrehd-a-gwé:gǫh]	it.a-car-joinerA-all
oˀdréhdatgiˀ	‘ugly car’	[o-ˀdréhd-a-tgiˀ]	it.o-car-joinerA-dirty/ugly
onę́hętgiˀ	‘dirty corn’	[o-nę́hę-tgiˀ]	it.o-corn-dirty/ugly
ga̲ˀdréhde:s	‘it is a long car’	[ga̲-ˀdréhd-e:s]	it.a-car-long
ga̲ˀdrehdí:yo:	‘it is a nice car’	[ga̲-ˀdrehd-í:yo:]	it.a-car-nice
nigaˀdre̲hdú:ˀuh	‘it is a small car’	[ni-ga-ˀdre̲hd-ú:ˀuh]	partitive-it.a-car-small
akyę́da̲hkwaˀ	'chair'	[akyę́d-a-hkwaˀ]	sit-joinerA-instrumental
ehyádǫ̲hkwaˀ	'writing implement (pen, pencil, etc.)'	[e-hyádǫ̲-hkwaˀ]	someone-write-instrumental
ga̲ˀdréhdaęˀ	‘one parked car’	[ga̲-ˀdréhd-a-ęˀ]	it.a-car-joinerA-lie
gá:yęˀ	‘it is lying on the ground’	[gá:-yęˀ]	it.a-lie.stative
węˀníhsga:ˀ	‘a wheel’	[w-ęˀníhsga:-ˀ]	it.a-wheel-noun.stem.former
wę̲ˀníhsgaǫt	‘it has one wheel’	[w-ę̲ˀníhsga-ǫt]	it.a-wheel-attached
ó:ga:ˀ	‘a price’	[ó:-ga:-ˀ]	it.o-price-noun.stem.former
ogáot	‘a debt’	[o-gá-ot]	it.o-price-stand
sa̲hohdęgyǫ́hǫgyeˀ	'he is on his way home'	[sa̲-ho-hdęgy-ǫ́h-ǫ-gy-e-ˀ]	repetitive-he.o-leave-stative-joinerA-progressive-go-stative
agade̲ˀgwę́hęgyeˀ	'I am running away again’	[ag-ade̲-ˀgw-ę́h-ę-gy-e-ˀ]	I.a-semireflexive-run.away-stative-joinerA-progressive-go-stative
go̲hsganye̲há:gyeˀ	'she is shuffling along’	[go̲-hsganye̲-h-á:-gy-e-ˀ]	she.o-shuffle-pronunciation.h-joinerA-progressive-go-stative
agyǫdi̲há:gyeˀ	'I am going along smiling'	[ag-yǫdi̲-h-ágy-e-ˀ]	I.a-smile-pronunciation.h-joinerA-progressive-go-stative
dęsehehdáwęnye:ˀ	‘you will tend or till your garden’	[d-ę-se-hehd-á-węnye-:ˀ]	dualic-future-you(one).a-joinerE-earth-joiner-stir-punctual
sedá:kseˀ	'you are running'	[s-e-dá:kse-ˀ]	you(one).a-joinerE-run-stative
í:se:k	'eat it!'	[í:-s-e:-k]	prothetic-you(one).a-joinerE-eat.punctual
segǫ́hsa̲ˀgeh	'on your face'	[s-e-gǫ́hs-a̲ˀgeh]	you(one).a-joinerE-face-on
ęsé:gęˀ	'you will see'	[ę-s-é:-gę-ˀ]	future-you(one).a-joinerE-see-punctual
ęhsewayę:nę́:daˀ	'you will complete'	[ę-hs-e-wayę:nę́:d-aˀ]	future-you(one).a-joinerE-complete-punctual
syę́:sehs	‘you skin animals all the time’	[s-yę́:se-hs]	you(one).a-skin-habitual
snętsáˀgeh	'on your arm'	[s-nęts-áˀgeh]	you(one).a-arm-on
sǫtsáˀgeh	'on your knee'	[s-ǫts-áˀgeh]	you(one).a-knee-on
SHehó:wih	‘tell her’	[she-hró:wi-h]	you:her-tell-pronunciation.h
SGa̲ˀáhdra:t	‘one basket’	[s-ga̲-ˀáhdr-a:-t]	repetitive-it.a-basket-joiner-stand.stative
SWa̲hdegá:ˀgeh	‘on your ribs’	[swa̲-hdegá:-ˀgeh]	you(all).a-ribs-on
onǫnyáędagyeˀ	'it is freezing'	[o-nǫny-á-ę-d-a-gy-e-ˀ]	it.o-ice-joinerA-lie.stative-pronunciation.D-joinerA-progressive-go-stative
onǫ́nyaęˀ	'it is frozen'	[o-nǫ́ny-a-ęˀ]	it.o-ice-joinerA-lie.stative
awęnowaędá:gyeˀ	'it is sinking'	[aw-ęnowaę-d-á:-gy-e-ˀ]	it.o-sink-pronunciation.D-joinerA-progressive-go-stative
ęwęnǫwáęˀ	'it will sink'	[ę-w-ęnǫwáę-ˀ]	future-it.a-sink-punctual
tgiˀdrǫ́:daˀk	'where I lived'	[t-g-iˀdrǫ́:-d-a-ˀk]	cislocative-I.a-live.stative-pronunciation.D-joinerA-past
tgiˀdrǫˀ	'where I live, reside' shęh ‘that’	[t-g-iˀdrǫ-ˀ]	cislocative-I.a-live-stative
agadowihshę́:daˀk	'I did have a rest'	[ag-ad-owihshę́:-d-a-ˀk]	I.o-semireflexive-rest.stative-pronunciation.D-joinerA-past
agadowíshęˀ	'I have rested'	[ag-ad-owíshę-ˀ]	I.o-semireflexive-rest-stative
gǫ́:yǫˀ	‘I will give you’	[gǫ́:-y-ǫ-ˀ]	I:you-pronunciation.Y-give-punctual
sheyahǫ́:dǫ:	‘ask her!’	[she-y-ahǫ́:dǫ:]	you:her-pronunciation.Y-ask-ø.aspect
degaǫwę́hda:s	‘they (females or mixed group) run’	[de-gaǫ-w-ę́hda:-s]	dualic-they-pronunciation.W-run-habitual
da:gáǫwę̲hda:t	‘they (females or mixed group) might run’	[d-a:-gáǫ-w-ę̲hda:t-ø]	dualic-indefinite-they-pronunciation.W-run-ø.punctual
dewagę̲hdá:dǫh	‘I have run’	[de-wag-ę̲hdá:d-ǫh]	dualic-I.o-run-stative
í:se:k	‘you eat it!’	[í:-s-e:-k]	prothetic-you(one).a-joinerE-eat.punctual
á:se:k	‘you should eat it’	[á:-s-e:-k]	indefinite-you(one).a-joinerE-eat.punctual
ę́:se:k	‘you will eat it’	[ę́:-s-e:-k]	future-you(one).a-joinerE-eat.punctual
ikne:	'you and I want, think’	[i-kn-e:]	pronunciation.I-we.two.inclusive.a-think.stative
akne:	'we two (not you) want, think’	[akn-e:]	we.two.exclusive.a-think.stative
idwe:	'we all (including you) want, think’	[i-dw-e:]	pronunciation.I-we.all.inclusive.a-think.stative
agwe:	'we all (not you) want, think’	[agw-e:]	we.all.exclusive.a-think.stative
ihe:	'he wants, thinks’	[i-h-e:]	pronunciation.I-he.a-think.stative
hę́:ne:	'they (males) want, think’	[hę́:n-e:]	they(males).a-think.stative
í:geˀs	'I am here'	[í:-g-e-ˀs]	pronunciation.I-I.a-go-habitual
ihsgeˀs	'I amback home'	[i-hs-g-e-ˀs]	pronunciation.I-repetitive-I.a-go-habitual
í:drah	'spread it on'	[í:-d-rah]	pronunciation.I-you(one).a-spread
í:ga:ˀ	'it contains'	[í:-ga:ˀ]	pronunciation.I-it.contain.stative
í:ga:t	'it is standing'	[í:-ga:-t]	pronunciation.I-it.a-stand.stative
í:gye:t	'she is standing over there'	[í:-g-ye:-t]	pronunciation.I-cislocative-she.a-stand.stative
ihe:	'he wants it'	[i-h-e:]	pronunciation.I-he.a-want.stative
ihse:	'you want'	[i-hs-e:]	pronunciation.I-you(one).a-want.stative
ikda:s	'I am stringing or draping it'	[i-k-dahsd]	pronunciation.I-I.a-string.up.habitual
ita:t	'he is standing over there'	[i-t-ha:-t]	pronunciation.I-cislocative-he.a-stand.stative
í:yoˀ	'it is in the water'	[í:-y-oˀ]	pronunciation.I-it.o-submerged.stative
í:yǫ:s	'it is long'	[í:-y-ǫ:s]	pronunciation.I-it.o-long.stative
ihsé:hah	'you (s) gloat'	[i-hs-é-:hah]	pronunciation.I-you(one).a-think.stative-diminutive
ihé:hah	'he thinks highly of himself'	[i-h-é-:hah]	pronunciation.I-he.a-think.stative-diminutive
igé:hah	'I am gloating, boastful'	[i-g-é-:hah]	pronunciation.I-I.a-think.stative-diminutive
tiwa:gǫ́:ni:	‘I have made it in place of something else, replaced it’	[ti-wa:g-ǫ́:ni-:]	contrastive-I.a-make-stative
Gwahsdǫhó:nǫˀ	'Americans'	[gwahsdǫ-hó:nǫˀ]	ø.prefix-boston
Gwahsdǫhonǫˀgeh	'United States'	[gwahsdǫ-honǫ-ˀgeh]	ø.prefix-boston-populative-on
Gwahsdǫhonǫˀge̲hó:nǫˀ	'United States citizen'	[gwahsdǫh-honǫh-ˀge̲-hó:nǫˀ]	ø.prefix-boston-populative-on-populative
oyajihó:nǫˀ	'stranger, alien'	[o-ya-ji-hó:nǫˀ]	it.o-other-intensifier-populative
oyá:jih	'another type'	[o-yá:-jih]	it.o-other-intensifier
gi̲hęˀgowáhneh	‘to the big river’	[gi̲hęˀ-gowá-hneh]	river-big-at
gi̲hę:gó:wah	‘the big river’	[gi̲hę:-gó:wah]	river-big
ahsgwáˀgeh	‘on the roof’	[ahsgwá-ˀgeh]	roof-on
oíhwa̲ˀgeh	‘the reason, idea for something’	[o-ríhwa̲-ˀgeh]	it.o-matter-on
oíhwaˀ	‘message,word, affair, business’	[o-ríhw-aˀ]	it.o-matter-nsf
adę́ˀhęˀgeh	‘on the fence’	[adę́ˀhę-ˀgeh]	fence-on
adę́ˀhęˀ	‘fence’	[adę́ˀh-ęˀ]	fence-nsf
snętsáˀgeh	‘on your (sg.) arm’	[s-nętsá-ˀgeh]	you(one).a-arm-on
knętsáˀgeh	‘on my arm’	[k-nętsá-ˀgeh]	I.a-arm-on
enę́tsa̲ˀgeh	‘on her arm’	[e-nę́tsa̲-ˀgeh]	she.a-arm-on
otówe̲ˀgeh	‘North’	[o-tówe̲-ˀgeh]	it.o-cold.stative-on
otó:weˀ	‘it is cold’	[o-tó:weˀ]	it.o-cold.stative
onénǫ̲ˀgeh	‘South’	[o-nénǫ̲-ˀgeh]	it.o-warm.stative-on
oné:nǫˀ	‘it is mild, warm’	[o-né:nǫˀ]	it.o-warm.stative
eˀnikǫhkwáˀgeh	‘sewing room’	[e-ˀnikǫhkwá-ˀgeh]	someone-sews.habitual-on
eˀníkǫhkwaˀ	‘she sews’	[e-ˀníkhǫkw-haˀ]	she.a-sew-habitual
ekǫnya̲ˀtáˀgeh	‘kitchen’	[e-kǫnya̲ˀtá-ˀgeh]	someone-cooks.habitual-on
ekǫ́nya̲ˀtaˀ	‘she cooks’	[e-kǫ́nya̲ˀd-haˀ]	she.a-cook-habitual
Ga̲hnawiyóˀgeh	‘Oklahoma’	[ga̲-hnaw-iyó-ˀgeh]	it.a-flowing.water-good.stative-on
ga̲hna:wí:yo:	‘nice rapids’	[ga̲-hna:w-í:yo:]	it.a-flowing.water-good.stative
í:ˀgeh	‘on my side’; ‘as for me’	[i:-ˀgeh]	I-on
gi̲hęˀgowáhneh	‘to the big river’	[gi̲hęˀ-gowá-hneh]	river-big-at
gi̲hę:gó:wah	‘the big river’	[gi̲hę:-gó:wah]	river-big
hęnǫ́gwe̲hneh	‘men's washroom’	[hęn-ǫ́gwe̲-hneh]	they(males).a-people-at
hęnǫ́:gweh	‘men’	[hęn-ǫ́:gweh]	they(males).a-people
gęnhéhneh	‘summer’	[g-ęnhé-hneh]	it.a-summer-at
Gwésa̲hsneh	‘Akwesasne’	[gwésa̲hs-hneh]	partridge-at
go̲hsréhneh	‘winter’	[go̲hsré-hneh]	cold.place-at
Hyáikneh	‘June’	[hyá-ik-hneh]	berry-ripen-at
Jíhsgę̲hneh	‘August’	[jíhsgę̲-hneh]	corn.husk-at
Sáˀgę̲hneh	‘September’	[sáˀgę̲-hneh]	cough-at
Saˀgę̲hnehgó:wah	‘October’	[saˀgę̲-hneh-gó:wah]	cough-at-big
Ohwęjagáyǫ̲hneh	‘Europe’	[o-hwęja-gáyǫ̲-hneh]	it.o-land-old.stative-at
Mariaˀgeh	'at Maria's place' name '	[maria-hneh]	maria-at
hyáikneh	'June' (former) atypical word functioning as a ‘noun’	[hya-ik-hneh]	berry-ripen-at
Sawęhe:sgeh	'at Sawęhe:s's place' verb functioning as a ‘name’	[sawęhe:s-ˀgeh]	sawęhe:s-at
hyáikhne̲hgeh	'berry ripening time' (former) atypical word functioning as a ‘noun’	[hya-ik-hne̲h-ˀgeh]	berry-ripen-at-on
nigę́hne:s	'just a length of cloth' tsǫ́: ‘just’	[ni-g-ę́hn-e:s]	partitive-it.a-cloth-long
í:yǫ:s	'it is long'	[í:-y-ǫ:s]	partitive-it.o-long.stative
ohsnó:weˀ	'it is fast, quick'	[o-hsnó:weˀ]	it.o-fast.stative
haksaˀdasé:ˀah	'teenager'	[ha-ksaˀd-asé:-ˀah]	he.a-child-new-diminutive
haksá:ˀah	'a male child, boy'	[ha-ksá:-ˀah]	he.a-child-diminutive
hehjíˀah	'my older brother'	[he-hjí-ˀah]	he:me-older.sibling-diminutive
hehjiˀ	'pet name for 'my older brother’	[he-hjiˀ]	he:me-older.sibling
kehjíˀah	'my older sister'	[keh-jí-ˀah]	she:me-older.sibling-diminutive
kehjiˀ	'pet name for 'my older sister’	[ke-hjiˀ]	she:me-older.sibling
owi:yá:ˀah	'baby'	[o-wi:yá:-ˀah]	it.o-offspring-diminutive
owí:yaˀ	'its young, offspring’ neˀ ‘the’	[o-wí:y-aˀ]	it.o-offspring-nsf
ohstwa:sˀah	‘young animal, little animal, tadpole’	[o-hstwa:-s-ˀah]	it.o-shrink-pluralizer-diminutive
wahstwahs	‘it shrinks’	[wa-hstwa-hs]	it.a-shrink-habitual
niyǫ́:sˀah	‘just a little bit long’	[ni-y-ǫ:s-ˀah]	partitive-it.a-long.stative-diminutive
í:yǫ:s	‘it is long’	[i:-y-ǫ:s]	prothetic-it.a-long.stative
nigęhné:sˀah	‘a short length of cloth’	[ni-g-ęhn-é:s-ˀah]	partitive-it.a-skin-long.stative-diminutive
nigę́hne:s	‘a length of cloth, material’	[ni-g-ęhn-e:s]	partitive-it.a-skin-long.stative
oˀgá:sˀah	'evening'	[o-ˀgá:s-ˀah]	it.o-evening.stative-diminutive
deyóˀga:s	'the night is coming’; ‘early night'	[de-yó-ˀga:s]	dualic-it.o-evening.stative
ihé:ˀah	'he is just walking along'	[i-h-é:-ˀah]	prothetic-he.a-go.stative-diminutive
iheˀ	'he is walking, moving'	[i-h-e-ˀ]	prothetic-he.a-go.stative
a:wé:tˀah	'it is implied, pretend'	[a:-w-é:t-ˀah]	indefinite-it.a-cause.to.think-diminutive
á:we:ˀ	'it should want, think'	[á:-w-e:-ˀ]	indefinite-it.a-think-punctual
tiyó:tˀah	'it is queer, unusual, odd'	[ti-yó:-t-ˀah]	contrastive-it.o-stand.stative-diminutive
tiganǫ̲hsa:dé:ˀah	'not a normal house'	[ti-ga-nǫ̲hs-a:dé:-ˀah]	contrastive-it.a-house-exist.stative-diminutive
tęhayętó:ˀah	'he will just plant it any old way or place, helter-skelter'	[t-ę-ha-yętó:-ˀah]	contrastive-future-he.a-plant.punctual-diminutive
hahe:tgę́:sˀah	'he is unattractive'	[ha-he:tgę́:-s-ˀah]	he.a-ugly.stative-plural-diminutive
hahé:tgęˀ	'he is ugly'	[ha-hé:tgęˀ]	he.a-ugly.stative
onǫhsatgí:sˀah	'ugly house'	[o-nǫhs-a-tgí:-s-ˀah]	it.o-house-joinerA-ugly.stative-plural-diminutive
onǫ́hsatgiˀ	'dirty house'	[o-nǫ́hs-a-tgiˀ]	it.o-house-joinerA-ugly.stative
ga̲hwajiyowanę́:hah	'my family is fairly big'	[ga-hwajiy-owanę́:-hah]	it.a-family-big.stative-diminutive
ga̲hwajiyówanęh	'big family'	[ga-hwajiy-ówanęh]	it.a-family-big.stative
niyǫ́:hah	'few, a little bit'	[ni-y-ǫ́:-hah]	partitive-it.o-a.certain.amount.stative-diminutive
ní:yǫ:	'amount of things'	[ní:-y-ǫ:]	partitive-it.o-a.certain.amount.stative
sgęnǫgowá:hah	'slowly, fairly slow'	[s-g-ęnǫ-gowá:-hah]	repetitive-it.a.originate.from-big-diminutive
gowa:nę́:hah	'it is fairly big'	[g-owa:nę́:-hah]	it.big.stative-diminutive
ihé:hah	'he thinks highly of himself'	[i-h-é:-hah]	prothetic-he.a-think.stative-diminutive
shede̲hjí:hah	'early morning' atypical word functioning as a ‘noun’	[shede̲h-jí:-hah]	early.morning-intensifier-diminutive
tsishéhde̲hjih	'this morning'	[tsi-shéde̲h-jih]	coincident-early.morning-intensifier
gagwíde̲hneh	'springtime, in the spring'	[ga-gwíde̲-hneh]	it.a-early.spring-at
ęyóˀga:ˀ	'tonight'	[ę-yó-ˀga:-ˀ]	future-it.o-evening-punctual
oˀga:sˀahné:hah	'eveningish'	[o-ˀga:s-ˀah-hné:-hah]	it.o-evening.stative-diminutive-at-diminutive
oˀgá:sˀah	'evening'	[o-ˀgá:s-ˀah]	it.o-evening.stative-diminutive
hagę́hjih	'old man'	[ha-gę́hjih]	he.a-old.stative
niyagawé:nǫh	'female stranger'	[ni-yagaw-é:nǫ-h]	partitive-cislocative-she.o-originate.from-habitual
dagu:sgó:wah	'big cat'	[dagu:s-gó:wah]	cat-big
onǫhdagó:wah	'burdock'	[o-nǫhd-a-gó:wah]	it.o-bur-joinerA-big
onǫ́hdaˀ	'bur'	[o-nǫ́hd-aˀ]	it.o-bur-nsf
otręˀdagó:wah	'horsefly'	[o-tręˀd-a-gó:wah]	it.o-fly-joinerA-big
otrę́ˀdaˀ	'fly'	[o-trę́ˀd-aˀ]	it.o-fly-nsf
gwa̲ˀyǫgó:wah	'jackrabbit'	[gwa̲ˀyǫ-gó:wah]	rabbit-big
Gayane̲hsraˀgó:wah	'the Great Law'	[ga-yane̲hsr-aˀ-gó:wah]	it.a-law-joinerA-big
gayáne̲hsraˀ	'rights, laws, code'	[ga-yane̲hsr-aˀ]	it.a-law-nsf
ohstowagó:wah	'Great Feather Dance'	[o-hstow-a-gó:wah]	it.o-feather-joinerA-big
awęheˀgó:wah	'eagle'	[awęheˀ-gó:wah]	ø.prefix-wing-big
ga̲hnyaˀsesgó:wah	'giraffe'	[ga̲-hnyaˀs-es-gó:wah]	it.a-neck-long.stative-big
ga̲hnyáˀse:s	'it has a long neck'	[ga̲-hnyáˀs-e:s]	it.a-neck-long.stative
okdéhatgiˀ	'dirty or ugly root'	[o-kdéh-a-tgiˀ]	it.o-root-joinerA-ugly.stative
gayęˀgwasgó:wah	'tobacco worm'	[ga-yęˀgw-a-k-s-gó:wah]	it.a-tobacco-joinerA-eat-habitual-big
gayę́ˀgwa:s	'it eats tobacco'	[ga-yęˀgw-a-k-s]	it.a-tobacco-joinerA-eat-habitual
gawęno̲hgriya̲ˀsgó:wah	'weed or brush cutter'	[ga-węno̲hgr-iya̲ˀk-s-gó:wah]	it.a-weed-cut-habitual-big
gawęno̲hgrí:yaˀs	'it cuts weeds'	[ga-węno̲hgr-í:yaˀk-s]	it.a-weed-cut-habitual
agawęgę́hę:ˀ	'it used to be mine'	[ni:ˀ] ‘I’ [ag-aw-ę-gę́hę:ˀ]	I.o-own-stative-past
agá:węh	'mine'	[ag-á:w-ęh]	I.o-own-stative
hó:węh	'his'	[hó:-w-ęh]	he.o-own-stative
eksaˀdasé:gę̲hę:ˀ	‘a former teenage girl'	[e-ksaˀd-asé:-gę̲hę:ˀ]	she.a-child-new.stative-past
eksaˀdasé:ˀah	'teenage girl'	[e-ksaˀd-asé:-ˀah]	she.a-child-new.stative-diminutive
akyęda̲hkwáˀgę̲hę:ˀ	'a former chair'	[akyęda̲hkw-áˀ-gę̲hę:ˀ]	ø.prefix-chair-joinerA-past
akyę́da̲hkwaˀ	'chair'	[akyę́da̲hkw-aˀ]	ø.prefix-chair-nsf
gokyęda̲hkwáˀgę̲hę:ˀ	'it used to be her chair'	[go-kyęda̲hkw-áˀ-gę̲hę:ˀ]	her-chair-joinerA-past
knoha:ˀahgęhę:ˀ	'my former aunt'	[k-noha:ˀah-gęhę:ˀ]	I.a-aunt-past
kno:há:ˀah	'my aunt'	[k-no:há:ˀah]	I.a-aunt
hehjiˀahgę́hę:ˀ	'my former older brother'	[he-hjiˀah-gę́hę:ˀ]	he:me-older.sibling-past
hehjíˀah	'my older brother'	[he-hjíˀah]	he:me-older.sibling
haˀnígę̲hę:ˀ	'my former father'	[ha-ˀní-gę̲hę:ˀ]	he.a-father-past
haˀnih	'my father'	[ha-ˀnih]	he.a-father
knoháˀgę̲hę:ˀ	'my former mother'	[k-noháˀ-gę̲hę:ˀ]	I.a-mother-past
knó:haˀ	'my mother'	[k-nó:haˀ]	I.a-aunt
ǫgya:dáogę̲hę:ˀ	'my former ceremonial friend'	[ǫgy-a:d-áo-gę̲hę:ˀ]	we.all-semireflexive-ceremonial.friend-past
ǫgya:dáoˀ	'my ceremonial friend'	[ǫgy-a:d-áoˀ]	we.all-semireflexive-ceremonial.friend
ǫgyatsihgę́hę:ˀ	'my former friend'	[ǫgy-atsih-gę́hę:ˀ]	we.all-friend-past
ǫgyá:tsih	'my friend'	[ǫgy-á:tsih]	we.all-friend
ǫgwehǫwéhne̲ha:ˀ	'Indian way'	[ǫgweh-ǫwéh-ne̲ha:ˀ]	people-typicalizer-customary
ǫgwehǫ́:weh	'Indian'	[ǫgweh-ǫ́:weh]	people-typicalizer
hnyǫˀǫhnéha:ˀ	'white kind'	[hnyǫˀǫh-néha:ˀ]	white.stative-customary
shede̲hjihahnéha:ˀ	'brunch time, mid-morning, early morning'	[shede̲h-ji-hah-néha:ˀ]	early.morning-intensifier-diminutive-customary
shede̲hjí:hah	'early morning'	[shede̲h-jí:-hah]	early.morning-intensifier-diminutive
ǫgwehǫ́:weh	'Indian'	[ǫgweh-ǫ́:weh]	ø.prefix-people-typicalizer
otowe̲ˀgéha:ˀ	'the northern kind'	[o-t-howe̲ˀ-géha:ˀ]	it.o-semireflexive-cold.stative-customary
otówe̲ˀgeh	'north'	[o-t-howe̲-ˀgeh]	it.o-semireflexive-cold.stative-on
twę:twę́:tge̲ha:ˀ	'duck dance'	[twę:twę́:t-ge̲ha:ˀ]	duck-customary
hnyagwaiˀgéha:ˀ	'Bear Dance'	[hnyagwaiˀ-géha:ˀ]	bear-customary
ahsdéhka:ˀ	'outside type'	[ahsdéh-ka:ˀ]	ø.prefix-outside-customary
ahsdeh	'outside'	[ahsdeh]	ø.prefix-outside
go̲hsréhka:ˀ	'winter kind'	[go̲hsréh-ka:ˀ]	ø.prefix-cold.place-customary
go̲hsréhneh	'winter'	[go̲hsré-hneh]	ø.prefix-cold.place-at
ędéhka:ˀ	'day kind'	[ęd-éh-ka:ˀ]	ø.prefix-day-go.aspect-customary
ę́:deh	'day'	[ę́:d-eh]	ø.prefix-day-go.aspect
ahsǫ́hehka:ˀ	'night kind'	[ahsǫ́h-eh-ka:ˀ]	ø.prefix-night-go.aspect-customary
ahsǫ́heh	'night'	[ahsǫ́h-eh]	ø.prefix-night-go.aspect
ga̲hnyǫ́ˀǫhka:ˀ	'white man's kind'	[ga̲-hnyǫ́ˀǫh-ka:ˀ]	it.a-white.stative-customary
hahnyǫ́ˀǫh	'white man'	[ha-hnyǫ́ˀǫh]	he.a-white.stative
Ga̲hnawa̲ˀgehó:nǫˀ	'Caughnawagans'	[ga̲-hnaw-a̲-ˀgeh-hó:nǫˀ]	it.a-rapids-joinerA-on-populative
Ga̲hnáwa̲ˀgeh	'Caughnawaga'	[ga̲-hnáw-a̲-ˀgeh]	it.a-rapids-joinerA-on
ganyada:ˀge̲hó:nǫˀ	'lake people, cottagers'	[ga-nyada:-ˀgeh-hó:nǫˀ]	it.a-lake-on-populative
ganyadá:ˀgeh	'to, at the lake'	[ga-nyadá:-ˀgeh]	it.a-lake-on
ǫhnyaˀge̲hó:nǫˀ	'people of the river flats'	[ǫhny-a-ˀgeh-hó:nǫˀ]	ø.prefix-river.flats-joinerA-on-populative
ǫhnyáˀgeh	'on the river flats'	[ǫhny-á-ˀgeh]	ø.prefix-river.flats-joinerA-on
oyajihó:nǫˀ	'stranger, alien'	[o-ya-ji-hó:nǫˀ]	it.o-other-intensifier-populative
oyá:jih	'another type'	[o-yá:-jih]	it.o-other-intensifier
Ganeda̲ˀgehó:nǫˀ	'Lower End People'	[ga-ned-a̲-ˀgeh-hó:nǫˀ]	it.a-valley-joinerA-on-populative
hadihǫwaˀge̲hó:nǫˀ	'sailors, navy men, merchant marines'	[hadi-hǫw-a-ˀge̲-hó:nǫˀ]	they(males).a-boat-joinerA-on
ga̲hǫ́:waˀ	'boat'	[ga̲-hǫ́:w-aˀ]	it.a-boat-nsf
Ga̲hnawiyoˀge̲hó:nǫˀ	'Oklahomans'	[ga̲-hnaw-iyo-ˀge̲h-hó:nǫˀ]	it.a-rapids-beautiful.stative-on-populative
Ga̲hnawiyóˀgeh	'Oklahoma'	[ga̲-hnaw-iyó-ˀgeh]	it.a-rapids-beautiful.stative-on
Ganǫhgwa̲ˀtrohó:nǫˀ	'Sour Spring People'	[ga-nǫhgwa̲ˀtr-o-hó:nǫˀ]	it.a-medicine-submerged.stative-on-populative
Ganǫ́hgwa̲ˀtroˀ	'Sour Springs'	[ga-nǫ́hgwa̲ˀtr-oˀ]	it.a-medicine-submerged.stative
Dagęhyathó:nǫˀ	'Upper End People'	[da-g-ęhy-a-t-hó:nǫˀ]	cislocative-it.a-mountain.top-stand.stative-on-populative
Gwahsdǫhó:nǫˀ	'Americans'	[gwahsdǫ-hó:nǫˀ]	ø.prefix-
Gwahsdǫhonǫˀge̲hó:nǫˀ	'United States citizen'	[gwahsdǫh-honǫh-ˀge̲-hó:nǫˀ]	ø.prefix-boston-populative-on-populative
Gwahsdǫhonǫˀgeh	'United States'	[gwahsdǫ-honǫ-ˀgeh]	ø.prefix-boston-populative-on
ahóhda̲ˀjih	'he really got full'	[a-hó-hda̲-ˀ-jih]	factual-he.o-get.full-punctual-intensifier
ahóhdaˀ	'he got full'	[a-hó-hda-ˀ]	factual-he.o-get.full-punctual
gęh?	'Are you (really) well?'	[s-g-ęnǫ́-jih]	repetitive-it.a-originate.from.stative-intensifier
Sgę́:nǫˀ.	'Hello'	[s-g-ę́:nǫˀ]	repetitive-it.a-originate.from.stative
ohnáˀgę̲ˀjih	'back then, back there, late, the bottom'	[o-hná:gę̲ˀ-jih]	it.o-under.stative-intensifier
ohnáˀgę:ˀ	'behind, late'	[o-hná:gę:-ˀ]	it.o-under.stative-nsf
hé:tgę̲hjih	'the very top'	[hé:tgę̲h-jih]	above-intensifier
ga̲ˀdrehda̲ˀsǫ́:ˀǫh	'many, a variety of cars'	[ga̲-ˀdrehd-aˀ-shǫ́:ˀǫh]	it.a-car-nsf-pluralizer
ga̲ˀdréhdaˀ	'car(s)'	[ga̲-ˀdréhd-aˀ]	it.a-car-nsf
ohǫda̲ˀsǫ́:ˀǫh	'bushes'	[o-hǫda̲ˀ-shǫ́:ˀǫh]	it.o-sapling-nsf-pluralizer
ohǫ́:daˀ	'whip(s)'	[o-hǫ́:d-aˀ]	it.o-sapling-nsf
jidęˀsǫ́:ˀǫh	'birds'	[jidęˀ-shǫ́:ˀǫh]	ø.prefix-bird-pluralizer
jidę́:ˀęh	'bird(s)'	[jidę́:-ˀeh]	ø.prefix-bird-pluralizer
agetgwę̲ˀdaˀsǫ́:ˀǫh	'my suitcases (ones that are scattered around)’	[age-tgwę̲ˀd-aˀ-shǫ́:ˀǫh]	my-wallet-nsf-pluralizer
agétgwę̲ˀdaˀ	'my suitcase(s), wallet(s), purse(s)'	[agé-tgwę̲ˀd-aˀ]	my-wallet-nsf
hadiksa̲ˀsǫ́:ˀǫh	'male children'	[hadi-ks-a̲ˀ-shǫ́:ˀǫh]	they(males).a-child-nsf-pluralizer
hadiksá:ˀah	'two boys'	[hadi-ks-á:ˀ-ˀah]	they(males).a-child-nsf-diminutive
gaeksa̲ˀsǫ́:ˀǫh	'female or mixed children'	[gae-ks-a̲ˀ-shǫ́:ˀǫh]	they(fe/males).a-child-nsf-pluralizer
gaeksá:ˀah	'two girls'	[gae-ksá:-ˀah]	they(fe/males).a-child-nsf-diminutive
ehstaˀ	'she uses or people use'	[e-hsd-haˀ]	someone-use-habitual
ga:gǫgwéˀdase:	'young women'	[ga:g-ǫgwéˀd-ase:]	they(fe/males).a-people-new.stative
gakeyadreˀsǫ́:ˀǫh	'my grandchildren'	[gakey-adreˀ-shǫ́:ˀǫh]	I:them-join.stative-pluralizer
gagéhǫˀ	'one of each thing lying around'	[sgat-shǫ́:ˀǫh]	one-pluralizer
hęwáge̲hoˀ.	'Oh, I'll be here around 5 o'clock.'	[hwihs-shǫ́:ˀǫh]	five-pluralizer
ta:dí:yǫˀ	'they came in one by one'	[sgat-shǫ́:ˀǫh]	one-pluralizer
agétgwę̲ˀdaˀ	'my suitcase(s), wallet(s), purse(s)'	[agé-twę̲ˀd-aˀ]	my-wallet-nsf
gakeyadréˀsǫˀ	'my grandchildren'	[gakey-adréˀ-shǫˀ]	I:them-join.stative-pluralizer
ǫdę́nǫ̲hksǫˀ	'relatives'	[ǫ-dę́-nǫ̲hk-shǫˀ]	someone-semireflexive-relative-pluralizer
agya:dę́:nǫhk	'my relative'	[agya:-dę́:-nǫhk]	my-semireflexive-relative
gakehji̲ˀáhsǫˀ	'my older siblings'	[gake-hji̲ˀáh-sǫˀ]	I:them-older.sibling-pluralizer
kehjíˀah	'my older sister'	[keh-jí-ˀah]	I:them-older.sibling
hwihsǫˀ	'five-ish, around 5:00'	[hwihs-shǫˀ]	five-pluralizer
sgatsǫˀ	'one at a time'	[sgat-shǫˀ]	one-pluralizer
deknísǫˀ	'by twos, two at a time '	[dekní-shǫˀ]	two-pluralizer
jo̲hsíˀdatsǫˀ	'one foot apart'	[j-o-hsíˀd-a-t-shǫˀ]	repetitive-it.o-foot-joinerA-stand.stative-pluralizer
jo̲hsíˀda:t	'one foot'	[j-o-hsíˀd-a:-t]	repetitive-it.o-foot-joinerA-stand.stative
sga̲ˀdréhdatsǫˀ	‘one car at a time’, ‘each car’, ‘per car’	[s-ga̲-ˀdrehd-a-t-shǫˀ]	repetitive-it.a-car-joinerA-stand.stative-pluralizer
sga̲ˀdréhda:t	'one car'	[s-ga̲-ˀdrehd-a:-t]	repetitive-it.a-car-joinerA-stand.stative
degadiyáhshesǫˀ	‘two things at a time’	[de-gadi-yáhshe-shǫˀ]	dualic-they(animals)/objects.a-two.things.stative-pluralizer
degadiyáhshe:	'two of them; they are two (things)'	[de-gadi-yáhshe:]	dualic-they(animals)/objects.a-two.things.stative
hoyę́twę̲hsǫˀ	'he planted several things'	[ho-yętw-ę̲h-shǫˀ]	he.o-plant-stative-pluralizer
hoyę́:twęh	'he planted'	[ho-yę́:tw-ęh]	he.o-plant-stative
sawę́hsǫˀ	'your belongings, property'	[sa-węh-shǫˀ]	you(one).o-own.stative-pluralizer
sá:węh	'you own something'	[sa-węh]	you(one).o-own.stative
ogáyǫ̲hsǫˀ	'old things'	[o-gáy-ǫ̲h-shǫˀ]	it.o-old-stative-pluralizer
ogá:yǫh	'it is old'	[o-gá:y-ǫh]	it.o-old-stative
shǫgwaęnáwisǫˀ	'he has given us songs'	[shǫgwa-ęn-áwi-shǫˀ]	he:us-song-give.stative-pluralizer
de̲honę̲hsóweksǫˀ	'they (m) have their shoes on'	[de̲-hon-ę̲hs-ówek-shǫˀ]	dualic-they(males).o-shoe-be.covered.stative-pluralizer
da̲ha:dí:yǫˀ	'they came in one by one'	[sgat-shǫˀ]	one-pluralizer
da̲ha:dí:yǫˀ	'they came in one by one'	[sgat-shǫ́:ˀǫh]	one-pluralizer
hadíksa̲ˀsǫˀ	'they are acting like boys'	[hadí-ksa̲ˀ-shǫˀ]	they(males).a-child-pluralizer
hadiksa̲ˀsǫ́:ˀǫh	'they are acting like boys'	[hadi-ksa̲ˀ-shǫ́:ˀǫh]	they(males).a-child-pluralizer
agetgwę̲ˀdaˀsǫ́:ˀǫh	'my suitcases (ones that are scattered around)’	[age-tgwę̲ˀd-aˀ-shǫ́:ˀǫh]	my-wallet-nsf-pluralizer
agétgwę̲ˀdaˀ	'my suitcase(s), wallet(s), purse(s)'	[agé-tgwę̲ˀd-aˀ]	my-wallet-nsf
hǫgweˀdí:yo:	‘he is a nice person’	[h-ǫgwe-ˀd-í:yo:]	he.a-person-increment-nice.stative
ga̲hnyagwáiˀda̲ˀgę:t	‘polar bear’	[ga̲-hnyagwái-ˀd-a̲-ˀgę:t]	it.a-bear-increment-joinerA-light.coloured.stative
ga̲ˀdréhdaˀ	'car'	[ga̲-ˀdréhd-aˀ]	it.a-car-noun.stem.former
ga̲ˀdréhde:s	'long car'	[ga̲-ˀdréhd-e:s]	it.a-car-long.stative
awę́nǫ̲hgraˀ	'weeds'	[awę́nǫ̲hgr-aˀ]	ø.prefix-weed-noun.stem.former
owę́nǫ̲hgre:s	'tall weeds'	[o-wę́nǫ̲hgr-e:s]	it.o-weed-long.stative
onóˀjaˀ	'teeth'	[o-nóˀj-aˀ]	it.o-tooth-noun.stem.former
onóˀje:s	'a fang'	[o-nóˀj-e:s]	it.o-tooth-long.stative
atgáhnye̲ˀtraˀ	'sports, games'	[at-gáhnye̲ˀ-tr-aˀ]	ø.prefix-semireflexive-play-nominalizer-nsf
satgáhnyeˀ	'play!'	[s-at-gáhnyeˀ]	you(one).a-semireflexive-play.no-aspect
gaihwanéˀaksraˀ	'sin'	[ga-ihwa-néˀak-sr-aˀ]	it.a-matter-sin-nominalizer-nsf
ęgrihwanéˀa:k	'I will sin'	[ę-g-rihwa-néˀa:k]	future-I.a-matter-sin.punctual
oyę́hsraˀ	'blanket(s), quilt(s)'	[o-yę́-hsr-aˀ]	it.o-lie-nominalizer-nsf
gá:yęˀ	' it is lying on the ground'	[gá:-yę-ˀ]	it.a-lie-stative
adeˀnyędę́hsraˀ	'measurement(s)'	[ade-ˀnyędę́-hsr-aˀ]	semireflexive-measure-nominalizer-nsf
ęhsade̲ˀnyę́:dęˀ	'you will try, measure'	[ę-hs-ade̲-ˀnyę́:dę-ˀ]	future-you(one).a-semireflexive-measure-punctual
ga̲hyádǫ̲hsraˀ	'paper'	[ga̲-hyádǫ̲-hsr-aˀ]	it.a-write-nominalizer-nsf
ehyá:dǫh	'she or someone writes'	[e-hyá:dǫ-h]	she.a-write-habitual
gayaˀdowéhdǫ:ˀ	'the idea of thinking'	[ga-yaˀdowéhd-ǫ:ˀ]	it.a-think-stative.nominal
ehyá:dǫh	'she writes'	[e-hyá:dǫ-h]	she.a-write-habitual
ǫtgáhiˀtaˀ	'what she plays with'	[ǫ-t-gáhiˀt-haˀ]	she.a-semireflexive-play.with-habitual
wadǫnyedáhkwaˀ	'gill'	[w-ad-ǫnyed-á-hkwaˀ]	it.a-semireflexive-cause.to.breathe-joinerA-instrumental
wadǫ́nyetaˀ	'how it breathes’; ‘its a breather'	[w-ad-ǫ́nyet-haˀ]	it.a-semireflexive-cause.to.breathe-habitual
hadiˀdrǫdáhkwaˀ	'pasture'	[hadi-ˀdrǫ-d-á-hkwaˀ]	they(animals)/objects.a-live-cause-joinerA-instrumental
ehwihsdáęda̲hkwaˀ	'a bank'	[e-hwihsd-á-ęda̲hkwaˀ]	someone-money-joinerA-cause.to.lie.stative-joinerA-instrumental
ǫdręnodáhkwaˀ	'musical instruments'	[ǫ-d-ręn-odáhkwaˀ]	someone-semireflexive-song-stand.stative-joinerA-instrumental
ǫtnaˀdáǫda̲hkwaˀ	'a bread pan'	[ǫ-t-naˀd-á-ǫda̲hkwaˀ]	someone-semireflexive-bread-joinerA-attached/sticking.out.stative-joinerA-instrumental
ahdahgwa̲ˀǫ́:weh	‘shoe’ (a special type worn by a corpse at a funeral); ‘a mocassin’	[ahdahgw-a̲ˀ-ǫ́:weh]	shoe-nsf-typicalizer
ahdáhgwaˀ	‘shoe’	[ahdáhgw-aˀ]	shoe-nsf
oyę́hsraˀ	‘blanket’	[o-yę́hsr-aˀ]	it.o-blanket-nsf
ohnyǫ́hsaˀ	‘squash’	[o-hnyǫ́h-saˀ]	it.o-squash-nsf
oyę́ˀgwaˀ	‘tobacco’	[o-yę́ˀgw-aˀ]	it.o-tobacco-nsf
onę́hę:ˀ	‘corn’	[o-nę́hę:-ˀ]	it.o-corn-nsf
ganǫ́hsaˀ	‘house’	[ga-nǫ́hs-aˀ]	it.a-house-nsf
ganaˀja̲ˀǫ́:weh	‘cooking pots used at the longhouse’	[ga-naˀj-a̲ˀ-ǫ́:weh]	it.a-pot-nsf-typicalizer
ǫgwehǫ́:weh	‘Indian’	[ǫgweh-ǫ́:weh]	person-typicalizer
ga̲hǫ́wagǫ:	'in a boat'	[ga̲-hǫ́w-a-gǫ:]	it.a-boat-joinerA-in
ga̲hǫ́:waˀ	'boat'	[ga̲-hǫ́:w-aˀ]	it.a-boat-nsf
oyádagǫ:	'in the basement, track'	[o-yád-a-gǫ:]	it.o-track-joinerA-in
oyá:daˀ	'basement, track'	[o-yá:d-aˀ]	it.o-track-nsf
ohǫ́dagǫ:	'in the bushes'	[o-hǫ́d-a-gǫ:]	it.o-sapling-joinerA-in
ohǫ́:daˀ	'whip, sapling’	[o-hǫ́:d-aˀ]	it.o-sapling-nsf
ǫgwanadá:gǫ:	'in our community'	[ǫgwa-nad-á:-gǫ:]	we.all-town-joinerA-in
ǫgwa:ná:daˀ	'our community'	[ǫgwa:-ná:d-aˀ]	we.all-town-nsf
adę́ˀhęgǫ:	'in the yard'	[adę́ˀhę-gǫ:]	fence-joinerA-in
adę́hęˀ	'fence'	[adę́hę-ˀ]	fence-nsf
ohnégagǫ:	'in the lake, water'	[o-hnég-a-gǫ:]	it.o-water-joinerA-in
ganyadá:gǫ:	'underneath the lake'	[ga-nyadá:-gǫ:]	it.a-lake-in
ǫhnyá:gǫ:	'in the river flats'	[ǫhnyá:-gǫ:]	river.flats-joinerA-in
ganéˀdagǫ:	'under the valley'	[ga-néˀd-a-gǫ:]	it.a-valley-joinerA-in
ohéhdagǫ:	'under the ground'	[o-héhd-a-gǫ:]	it.o-earth-joinerA-in
senhǫ́hdagǫ:	'your (singular) underarm'	[se-nhǫ́hd-a-gǫ:]	you(one).a-underarm-joinerA-in
sragwáhdagǫ:	'the ball of your foot'	[s-ragwáhd-a-gǫ:]	you(one).a-sole-joinerA-in
seséhdagǫ:	'the nape of your neck'	[se-séhd-a-gǫ:]	you(one).a-nape-joinerA-in
ganǫhsá:kˀah	'beside the house'	[ga-nǫhs-á:-kˀah]	it.a-house-joinerA-beside
ganǫ́hsaˀ	'house'	[ga-nǫ́hs-aˀ]	it.a-house-nsf
akyęda̲hkwá:ˀkˀah	'beside the chair'	[akyęda̲hkw-á:-kˀah]	ø.prefix-chair-joinerA-beside
akyę́da̲hkwaˀ	'chair'	[akyę́da̲hkw-aˀ]	ø.prefix-chair-nsf
ga̲hę:dá:ˀkˀah	'by the field'	[ga̲-hę:d-á:ˀ-kˀah]	it.a-field-joinerA-beside
ga̲hę́dagǫ:	'in the field, meadow'	[ga̲-hę́d-a-gǫ:]	it.a-field-joinerA-in
adę́hęˀ	'fence'	[adę́hę-ˀ]	ø.prefix-fence-nsf
gi̲hę́:kˀah	'along the river'	[gi̲hę́:-kˀah]	ø.prefix-
gi̲hę:	'river'	[gi̲hę:]	ø.prefix-river
nigaˀdre̲hdá:kˀah	'short car'	[ni-ga-ˀdre̲hd-á:-kˀah]	partitive-it.a-car-joinerA-short.stative
ganǫhsakdá:gyeˀ	'along the house'	[ga-nǫhs-a-kdá:gyeˀ]	it.a-house-joinerA-alongside
ganǫ́hsaˀ	'house'	[ga-nǫ́hs-aˀ]	it.a-house-nsf
gi̲hę́kdagyeˀ	'along the river'	[gi̲hę́-kdagyeˀ]	ø.prefix-river-alongside
gi̲hę:	'river'	[gi̲hę:]	ø.prefix-river
tiyó:tˀah	'it is queer, unusual, odd'	[ti-yó:-t-ˀah]	coincident-it.o-stand-diminutive
de̲hóyętwęh	‘he did not plant’	[tęˀ] not [de̲-hó-yętw-ęh]	negative-he.o-plant-stative
dejo:drę́:no:t	'it is not singing again'	[tęˀ] not [de-j-o:-d-rę́:n-o:t] ]	negative-repetitive-it.o-semireflexive-song-stand.stative
ta:gaesayę́:de:	‘they will not recognize you’	[tęˀ] not [t-a:-gaesa-yę́:de:-ø]	contrastive-indefinite-they:you-recognize-no.aspect
ta:gé:gęh	‘I will not or should not see it’	[tęˀ] not [t-a:-gé:-gę-h]	contrastive-indefinite-I.a-see-no.aspect/pronunciation.h
ętsyáˀdęˀ.	‘Wait, you might fall’ (literally, ‘you will fall into something’)	[Waˀjih] ‘wait’ [ę-t-s-yáˀd-ę-ˀ]	future-cislocative-you(one).a-body-fall-punctual
nęyá:węh.	'I just thought that's what would happen.’ (literally, ‘what will happen’)	[ahí:ˀ] ‘I.thought’ [giˀ] ‘just’ [to] ‘that’ [n-ę-yá:-w-ęh-ø]	partitive-future-it.o-happen-ø.punctual
gęh?	‘Do you want to come along with me?’	[ę-tn-é:-ˀ]	future-we.two.inclusive-go.purposive-punctual
diˀ?	‘Are you coming along?’	[ę-hsn-é:-ˀ]	future-you(two).a-go.purposive-punctual
ęyǫhdę́:diˀ?	'When is she going away?'	[hwę:dǫ́h] ‘when’ [ę-yǫ-hdę́:di-ˀ]	future-she.a-leave-punctual
ęhsyeh.	‘wake up!’	[ę-hs-yeh-ø]	future-you(one).a-awaken-ø.punctual
ęhsyǫ́:gyaˀt.	‘smile!’	[ę-hs-yǫ́:gyaˀd-ø]	future-you(one).a-smile-ø.punctual
ęháyętoˀ	'he will plant it'	[ę-há-yęto-ˀ]	future-he.a-plant-punctual
akní:nǫˀ	‘I bought it’	[a-k-hní:nǫ-ˀ]	factual-I.a-buy-punctual
ǫknéhagoˀ	‘I amamazed’, ‘I was amazed’	[ǫk-néhago-ˀ]	factual.I.o-amazed-punctual
sagádǫnhe:t	‘I amalive again’	[s-a-g-ád-ǫnhe:t-ø]	repetitive-factual-I.a-semireflexive-live-ø.punctual
deháyętwahs	'he is not a planter'	[tęˀ] not [de-há-yętw-a-hs]	negative-he.a-plant-joinerA-habitual
hayę́:twahs	'he is a planter'	[ha-yę́:tw-a-hs]	he.a-plant-joinerA-habitual
detgáhe:ˀ	'it is not setting over there'	[de-t-gá-he:ˀ]	negative-cislocative-it.a-setting.on.top.of.stative
dejo:drę́:no:t	'it is not singing again'	[tęˀ] not [de-j-o:-d-rę́:n-o:t] ]	negative-repetitive-it.o-semireflexive-song-stand.stative
jodrę́:no:t	'it is singing again'	[j-o-d-rę́:n-o:t]	repetitive-it.o-semireflexive-song-stand.stative
deyo:tó:weˀ	'it is not cold'	[tęˀ] not [de-yo:-t-hó:weˀ]	negative-it.o-semireflexive-cold.stative
otó:weˀ	'it is cold'	[o-t-hó:weˀ]	it.o-semireflexive-cold.stative
dehóyętwęh	'he is not planting; he hasn't planted'	[tęˀ] not [de-hó-yętw-ęh]	negative-he.o-plant-stative
hoyę́:twęh	'he is planting'	[ho-yę́:tw-ęh]	he.o-plant-stative
desadagáideˀ	'you feel sick'; 'you are not well'	[tęˀ] not [de-s-ad-agáideˀ]	negative-you(one).o-semireflexive-well.stative
degá:dę:s	'it is thin'; 'it is not thick'	[tęˀ] not [de-gá:-dę:s]	negative-it.a-thick.stative
dewagadǫtgá:dǫˀ	'I amunhappy'; 'I amnot happy'	[deˀ-ag-ad-ǫ́tgadeˀ], [de-wag-ad-ǫtgá:dǫˀ]	negative-I.o-semireflexive-happy.stative
desatnigǫhahdó:gęh	'you are immature in mind'; 'your mind is not mature’	[de-sa-t-ˀnigǫh-ahdó:g-ęh]	negative-you(one).o-semireflexive-mind-mature-stative
dehóge̲ˀo:t	'he is bald'; 'he has no hair'	[tęˀ] not [de-hó-ge̲ˀ-o:t]	negative-he.o-hair-stand.stative
dehonǫdánhęh	'he is innocent'; 'he is not guilty'	[de-ho-nǫdánh-ęh]	negative-he.o-guilty-stative
deˀaǫwé:saht	'it is unpleasant'; 'it is not pleasant'	[deˀ-a-ǫwé:saht]	negative-it.o-pleasant.stative
dehoihwa:dó:gę:	'he is a traitor'; 'he has not done right'	[de-ho-ihwa:-dó:gę:]	negative-he.o-matter-true.stative
dehoihwáęˀ	'he is innocent'; ‘nothing lies on him'	[sgahoˀdę́ˀ] nothing [de-ho-ihw-á-ęˀ]	negative-he.o-matter-joinerA-lie.stative
dehoˀnigǫ́ha:t	'he is ignorant, unthinkingly foolish'; 'he is not smart'	[de-ho-ˀnigǫ́h-a:-t]	negative-he.o-mind-joinerA-stand.stative
deyago̲ˀnigǫ̲há:gǫ:t	'she is uncompromising, unbending'; 'her mind does not dither'	[de-yago̲-ˀnigǫ̲h-á:-gǫ:t]	negative-she.o-mind-joinerA-persevere.stative
dedisa̲ˀnigǫ̲hí:yo:	'you are grumpy, grouchy'; 'you are not happy'	[de-di-sa̲-ˀnigǫ̲h-í:yo:]	negative-cislocative-you(one).o-mind-good.stative
desa:tǫ́:da:s	'you are disobedient'; 'you do not listen'	[de-s-a:t-hǫ́:da:-s]	negative-you(one).a-semireflexive-listen-habitual
deyǫtwaji:yǫ́:nih	'she is barren'; 'she cannot make a family'	[tęˀ] not [de-yǫ-t-hwaji:y-ǫ́:ni-h]	negative-it.o-semireflexive-family-make-habitual
desęˀnigǫhgáę	'you suffer'; 'your mind is not willing'	[de-s-ę-ˀnigǫh-gáę]	negative-you(one).o-semireflexive-mind-willing.stative
dewagegáę	'I am unwilling'; 'I do not want to do it'	[de-wag-e-gáę]	negative-I.o-joinerE-willing.stative
dehsnǫ́hweˀs	'you dislike'; 'you do not like'	[de-hs-nǫ́hwe-ˀs]	negative-you(one).a-like-habitual
desrihwanǫ́hweˀs	'you disapprove'; 'you do not approve'	[de-s-rihwa-nǫ́hwe-ˀs]	negative-you(one).a-matter-like-habitual
ta:hayę́:toh	‘he won't plant’	[t-a:-ha-yę́:to-h]	contrastive-indefinite-he.a-plant-no.aspect(pronunciation.h)
ęháyętoˀ	‘he will plant’	[ę-há-yęto-ˀ]	future-he.a-plant-punctual
gá:di:t	‘they (animals) are standing’	[gá:di:-t]	they.animals-stand.stative
tsaˀgaˀdre̲hdá:t	‘the same kind of car’	[tsaˀ-gá-ˀdre̲hd-a:-t]	coincident.factual-it.a-car-joinerA-stand.stative
sganǫ́hsa:t	‘one house’	[s-ga-nǫ́hs-a:-t]	repetitive-it.a-house-joinerA-stand.stative
tiyó:tˀah	‘it is queer, unusual, odd’	[ti-yó:-t-ˀah]	contrastive-it.o-stand.stative-diminutive
tsaˀónihseˀ	'it took a certain amount of time', or 'while a certain amount of time passed'	[ts-aˀ-ó-ni̲hse-ˀ]	coincident-factual-it.o-take.time-punctual
tsihágę̲hjih	'when he was an old man…'	[tsi-há-gę̲hjih]	coincident-he.a-old.person.stative
tsiyagwaksaˀsǫ́:ˀǫh	'when we were children…'	[tsi-yagwa-ksaˀ-shǫ́:ˀǫh]	coincident-we.all.exclusive.a-child-pluralizer
hohsę:	‘When he was young, he was fat.’	[tsi-h-ǫgwe̲ˀd-a:sé:]	coincident-he.a-person-new.stative
hǫgwéˀdase:	‘young man’	[h-ǫgwéˀd-ase:]	he.a-person-new.stative
tsiyeksa̲ˀdá:se:	'when she was a teenager…’	[tsi-ye-ksa̲ˀd-á:se:]	coincident-she.a-child-new.stative
eksaˀdasé:ˀah	‘teenage girl’	[e-ksaˀd-asé:-ˀah]	she.a-child-new.stative-diminutive
tsaˀgeht	‘I did it on purpose’	[ts-aˀ-g-ehd-ø]	coincident-factual-I.a-do.on.purpose-ø.punctual
ahahní:nǫˀ	‘he bought the same kind of car’ (as me)’	[tsaˀ-gá-ˀdre̲hd-a:-t]	coincident-factual-it.a-car-joinerA-stand.stative
tsiyaǫdadǫgę́hdǫh	'Sunday (past)'	[tsi-ya-ǫda-dǫgę́hd-ǫh]	coincident-it.o-day-make.right-stative
tsiyonakdóhaes	'Saturday (past)'	[tsi-yo-nakd-óhae-s]	coincident-it.o-bed-clean-habitual
tsigaǫ̲hyáhęh	'at noon (past)'	[tsi-ga-ǫ̲hy-á-hęh]	coincident-it.a-sky-joinerA-mid.stative
tsishéhde̲hjih	'this morning (earlier on in the day)'	[tsi-shéhde̲hjih]	coincident-ø.prefix-morning
tsigóhsreh	'winter past'	[tsi-g-óhsreh]	coincident-it.a-winter/year
tsaˀdę́hsyę:ˀ	‘you will put, lay them side by side’	[tsaˀd-ę́-hs-yę-:ˀ]	coincident.dualic-future-you(one).a-lay-punctual
tsaˀdégayęˀ	‘they are lying, setting side by side’	[tsaˀdé-ga-yę-ˀ]	coincident.dualic-it.a-lie-stative
tsaˀdęjatáhahk	‘you two will walk side by side’	[tsaˀd-ę-j-at-háh-a-hkw-ø]	coincident-dualic-future-you(two).a-semireflexive-road-joinerA-pick.up-ø.punctual
tsaˀdé:yoht	‘they are (literally, it is) the same, similar’	[tsaˀdé:-yo-ht]	coincident.dualic-it.o-resemble.stative
tsaˀdeyo̲hshé:dęh	‘it is the same number of’	[tsaˀde-yo̲-hshé:d-ęh]	coincident.dualic-it.o-count-stative
tsaˀdé:waˀs	‘they are (literally, ‘it is’) the same size’	[tsaˀdé:-w-aˀs]	coincident.dualic-it.a-be.a.certain.size.stative
tsaˀdé:yǫ:	‘of equal number, amount’	[tsaˀdé:-y-ǫ:]	coincident.dualic-it.o-be.a.certain.number.of.stative
tsaˀdewę̲hníhsra̲hęh	‘half a day’	[tsaˀde-w-ę̲hníhsr-a̲-hęh]	coincident.dualic-it.a-day-joinerA-sitting.on.top.of.stative
tsaˀdegáǫhya̲hęh	‘high noon’	[tsaˀde-gá-ǫhy-a̲-hęh]	coincident.dualic-it.a-sky-joinerA-sitting.on.top.of.stative
tsaˀdeganǫ́hsa̲hęh	‘in the middle of the house’	[tsaˀde-ga-nǫ́hs-a̲-hęh]	coincident.dualic-it.a-house-joinerA-sitting.on.top.of.stative
tsaˀdewa̲hsǫ́:tęh	‘at midnight’	[tsaˀde-w-a̲hsǫ́:t-hęh]	coincident.dualic-it.a-night-sitting.on.top.of.stative
tsaˀdeyoyę́hsrage:	‘they are two of the same kind of blanket’	[tsaˀde-yo-yę́hsr-age:]	coincident.dualic-it.o-blanket-be.two.or.more.stative
tsaˀdega̲ˀdréhdo̲ˀdę:	‘the cars look the same’	[tsaˀde-ga̲-ˀdréhd-o̲ˀdę:]	coincident.dualic-it.a-car-be.a.kind.stative
tsaˀdétgadeˀ	‘the same height’	[tsaˀdé-t-ga-deˀ]	coincident.dualic-cislocative-it.a-exist.stative
tsaˀdegyadǫ:dáik(hne:ˀ)	‘last week’	[tsaˀdeg-y-ad-ǫ:d-á-i-k-hne:ˀ]	coincident.dualic.cislocative-it.o-semireflexive-period
tsaˀdegyadǫ́dai	‘during the week’	[tsaˀdeg-y-ad-ǫ́d-a-i]	coincident.dualic.cislocative-it.o-semireflexive-period
tsaˀdegyadǫ́dadeˀ	‘during the week’	[tsaˀdeg-y-ad-ǫ́d-a-deˀ]	coincident.dualic.cislocative-it.o-semireflexive-period
tisǫgwe̲ˀdá:deˀ	‘you are a different person’	[ti-s-ǫgwe̲ˀd-á:deˀ]	contrastive-you(one).a-person-exist.stative
tihéhsǫˀ	‘he is a wanderer, loiterer’	[ti-h-é-hsǫˀ]	contrastive-he.a-go-pluralizer
tigęnenǫ́:gyeˀs	‘they (z) are roaming about’	[ti-gęn-enǫ́:-gye-ˀs]	contrastive-they(animals)/objects.a-originate.from-progressive-habitual
tiyó:tˀah	‘it is queer, unusual, odd’	[ti-yó:-t-ˀah]	contrastive-it.o-stand.stative-diminutive
tiga:gwé:gǫh	‘all over the place’, ‘here and there’	[ti-ga:-gwé:g-ǫh]	contrastive-it.a-all-stative
tiyogwé:gǫh	‘all of it’	[ti-yo-gwé:g-ǫh]	contrastive-it.o-all-stative
tęwadadǫ́:niˀ	‘it will emerge or appear unintentionally’; ‘it will do it by itself’	[t-ę-wa-dad-ǫ́:ni-ˀ]	contrastive-future-it.a-reflexive-make-punctual
taˀdehoˀnigǫ̲há:nih	‘he is unconcerned, indifferent’	[taˀde-ho-ˀnigǫ̲h-á:-nih]	contrastive.dualic-he.o-mind-joinerA-benefactive.habitual
taˀdegri̲hwáhsnyeˀ	‘I oppose it’; ‘I do not agree’	[taˀde-g-ri̲hw-áhsnye-ˀ]	contrastive.dualic-I.a-matter-care.for-stative
taˀdeyogaháędaht	‘it is fuzzy, out of focus, opaque, unclear’	[taˀde-yo-gah-á-ędaht-ø]	contrastive.dualic-it.o-eye-joinerA-cause.to.lie-ø.punctual
tsǫ:	‘he is just walking along’	[ti-h-e:-ˀáˀ tsǫ:]	contrastive-he.a-go-diminutive
iheˀ	‘he is walking, moving’	[i-h-e-ˀ]	prothetic-he.a-go-stative
tahayętó:ˀah	‘he planted it any old way’	[t-a-ha-yętó:-ˀah]	contrastive-factual-he.a-plant-diminutive
tigaˀdre̲hdá:deˀ	‘it is a different car from the others’	[ti-ga-ˀdre̲hd-á:-deˀ]	contrastive-it.a-car-joinerA-exist.stative
ga̲ˀdréhdaˀ	‘car, vehicle, truck’	[ga̲-ˀdréhd-aˀ]	it.a-car-nsf
tiganǫ̲hsá:deˀ	‘it is a different house from the others’	[ti-ga-nǫ̲hs-á:-deˀ]	contrastive-it.a-house-joinerA-exist.stative
ganǫ́hsaˀ	‘house’	[ga-nǫ́hs-aˀ]	it.a-house-nsf
tiganǫ̲hsa:dé:ˀah	‘not a normal house compared to the others’	[ti-ga-nǫ̲hs-a:-dé:-ˀah]	contrastive-it.a-house-joinerA-exist.stative-diminutive
tiyoyę̲hsrá:deˀ	‘it is an odd-ball blanket’	[ti-yo-yę̲hsr-á:-deˀ]	contrastive-it.o-blanket-joinerA-exist.stative
tigaˀdre̲hdá:deˀ	‘it is a different car from the others’	[ti-ga-ˀdrehd-á:-deˀ]	contrastive-it.a-car-joinerA-
tiganǫ̲hsá:deˀ	‘it is a different house from the others’	[ti-ga-nǫ̲hs-á:-deˀ]	contrastive-it.a-house-joinerA-exist.stative
ní:yǫ:	'an amount of things'	[ní:-y-ǫ:]	partitive-it.o-be.a.certain.amount.stative
[ni…+oˀdę:]	'a type of'; as in nigaęnóˀdę: 'a type of song'	[ni-ga-ęn-óˀdę:]	partitive-it.a-song-be.a.type.of.stative
niyó:weˀ	'how far in distance'	[ni-yó:-weˀ]	partitive-it.o-be.a.certain.distance.stative
niwuˀdrugyé:ˀah	'it is narrow'	[ni-w-uˀdrígyé:ˀah]	partitive-it.a-narrow.stative
niyo:há:kˀah	'it is short in height'	[ni-yo:-há:-kˀah]	partitive-it.o-measuring.line-short.stative
niyǫ́:hah	'a few, a little bit'	[ni-y-ǫ́:-hah]	partitive-it.o-be.a.certain.amount.stative-diminutive
niyǫ́:sˀah	'just a little bit long'	[ni-y-ǫ́:s-ˀah]	partitive-it.o-long.stative-diminutive
niwagri̲hú:ˀuh	'I amsensitive'	[ni-wag-ri̲h-ú:ˀuh]	partitive-I.o-matter-small.stative
nitgá:deˀ	'how high it is (inanimate object)'; 'the height of something'	[ni-t-gá:-deˀ]	partitive-cislocative-it.a-exist.stative
nigáha:ˀ	'how much it holds'	[ni-gá-ha:-ˀ]	partitive-it.a-hold-stative
niyohnodá:kˀah	'it is shallow'	[ni-yo-hnod-á:-kˀah]	partitive-it.o-water-joinerA-short.stative
niwú:ˀuh	'it is small, little'	[ni-w-ú:ˀuh]	partitive-it.a-small.stative
nita:wé:nǫ:	'a stranger'	[ni-t-ha:w-é:nǫ-:]	partitive-cislocative-he.o-originate.from-stative
nidihsé:no:?	'How old are you?'	[do:] how [ni-di-hs-é:no-:]	partitive-cislocative-you(one).o-originate.from-stative
nǫdá:ge:	'where I came from'	[nǫdá:-g-e-:]	partitive-factual-cislocative-I.a-go-aspect
ni̲hosriyáˀgǫˀ	'his age'	[ni̲-h-ohsr-iyáˀg-ǫˀ]	partitive-he.a-winter-cross.stative-plural
nǫgesyáoˀdę:	'I am... clan'	[n-ǫge-sya-oˀdę:]	partitive-factual.I.o-clan-be.a.certain.kind.stative
niwage̲hsyáoˀdę:	'I am... clan'	[ni-wage-hsya-oˀdę:]	partitive-I.o-clan-be.a.certain.kind.stative
niyó:tgiˀ	'how dirty or filthy it is'	[ni-yó:-tgiˀ]	partitive-it.o-ugly.stative
otgiˀ	'it is dirty or filthy'	[o-tgiˀ]	it.o-ugly.stative
niyéha:ˀ	'how much she holds'	[ni-yé-ha:-ˀ]	partitive-she.a-hold-habitual
eha:ˀ	'she is holding something'	[e-ha:-ˀ]	she.a-hold-habitual
nigá:nǫ:ˀ	'how much it costs'	[ni-gá:-nǫ:ˀ]	partitive-it.a-expensive.stative
ganǫ:ˀ	'it is expensive'	[ga-nǫ:ˀ]	it.a-expensive.stative
na̲ˀónisheˀ	‘it took an amount of time’	[n-a̲ˀ-ó-nishe-ˀ]	partitive-factual-it.o-take.time-punctual
nęyónisheˀ	‘it will take an amount of time’	[n-ę-yó-nishe-ˀ]	partitive-future-it.o-take.time-punctual
na̲ˀá:węh	'it happened (a fact)'	[n-a̲ˀ-á:w-ęh-ø]	partitive-factual-it.o-happen-ø.punctual
nęyá:węh	'it will happen'	[n-ę-yá:w-ęh-ø]	partitive-future-it.o-happen-ø.punctual
na:yá:węh	'it might, could, or would happen'	[n-a:-yá:w-ęh-ø]	partitive-indefinite-it.o-happen-ø.punctual
nigyé:haˀ	'I do it all the time'	[ni-g-yé:-haˀ]	partitive-I.a-do-habitual
nę́:gye:ˀ	'I will do it'	[n-ę́:-g-ye:-ˀ]	partitive-future-I.a-do-punctual
niyó:yę:	'what it is doing'	[ni-yó:-yę:]	partitive-it.o-do.stative
honahsgwagáˀdeˀ	‘he has many pets’	[ho-nahsgw-a-gáˀdeˀ]	he.o-domestic.animal-joinerA-be.many.stative
niyowęyohgá:ge:	'it is so many inches'	[ni-yo-węyohg-á:ge:]	partitive-it.o-thumb-certain.number.of.stative
nigagǫ̲ˀtrá:ge:	'that many pounds'	[ni-ga-gǫ̲ˀtr-á:ge:]	partitive-it.a-pound-certain.number.of.stative
nigahǫhsrá:ge:	'amount of boxes'	[ni-ga-hǫhsr-á:ge:]	partitive-it.a-box-certain.number.of.stative
nigana̲ˀjá:ge:	'amount of pails'	[ni-ga-na̲ˀj-á:ge:]	partitive-it.a-pail-certain.number.of.stative
nigayá:ge:	'amount of bags'	[ni-ga-yá:-ge:]	partitive-it.a-bag-certain.number.of.stative
niwęˀnhotrá:ge:	'amount of balls'	[ni-w-ęˀnhotr-á:ge:]	partitive-it.a-ball-certain.number.of.stative
nigawęná:ge:	'as many words'	[ni-ga-węn-á:ge:]	partitive-it.a-word-certain.number.of.stative
niyǫgwe̲ˀdá:ge:	'that many people'	[ni-y-ǫgwe̲ˀd-á:ge:]	partitive-it.o-person-certain.number.of.stative
niganǫ̲hsá:ge:	‘three houses’	[ni-ga-nǫ̲hs-á:ge:]	partitive-it.a-house-be.a.certain.number.stative
niwahda̲hgwá:ge:	‘three shoes’	[ni-w-ahda̲hgw-á:ge:]	partitive-it.a-shoe-be.a.certain.number.stative
niyohsi̲ˀdá:ge:	‘three feet’	[ni-yo-hsi̲ˀd-á:ge:]	partitive-it.o-foot-be.a.certain.number.stative
nigahǫnáˀdage:	‘three potatoes’	[ni-yo-hǫnáˀd-á:ge:] partitive-it.o-potato-be.a.certain.number.stative [ni-ga-hǫnáˀd-á:ge:]	partitive-it.a-potato-be.a.certain.number.stative
shoyę́:twęh	'he planted it again'	[s-ho-yę́:tw-ęh]	repetitive-he.o-plant-stative
hoyę́:twęh	'he planted it'	[ho-yę́:tw-ęh]	he.o-plant-stative
sawada̲hǫ́:dǫ:ˀ	'it asked again'	[sa-w-ad-a̲hǫ́:dǫ:-ˀ]	repetitive-factual-it.a-semireflexive-ask-punctual
awada̲hǫ́:dǫ:ˀ	'it asked'	[a-w-ad-a̲hǫ́:dǫ:-ˀ]	factual-it.a-semireflexive-ask-punctual
jago:kǫ́:ni:	'she is cooking again'	[j-ago:-k-ǫ́:ni-:]	repetitive-she.o-food-make-stative
odrę́:no:t	'it is singing'	[o-d-rę́:n-o:t]	it.o-semireflexive-song-stand.stative
jotó:weˀ	'it is cold again'	[j-o-t-hó:weˀ]	repetitive-it.o-semireflexive-cold.stative
otó:weˀ	'it is cold'	[o-t-hó:weˀ]	it.o-semireflexive-cold.stative
jidwáhshe:t	'let's count again'	[ji-dwá-hshe:t]	repetitive-we.all-count-ø.aspect
dwa̲hshe:t	'let's count'	[dwa̲-hshe:t]	we.all-count-ø.aspect
aˀé:yǫˀ	'she arrived'	[a-ˀé:-yǫ-ˀ]	factual-she.a-arrive-punctual
ahahdę́:diˀ	'he left'; 'he went away'	[a-ha-hdę́:di-ˀ]	factual-he.a-leave-punctual
hę́:geˀ	'I will go there'	[h-ę́:-g-e-ˀ]	translocative-future-I.a-go-punctual
í:geˀs	'I am here'	[í:-g-e-ˀs]	prothetic-I.a-go-habitual
shahá:wiˀ	'he brought it with him'	[s-ha-há:wi-ˀ]	repetitive-he.a-carry-punctual
hadihá:wiˀs	‘they (m) carry it along’	[hadi-há:wi-ˀs]	they(males).a-carry-habitual
Sganyádaes	'Long Lake'; 'Skaneateles, N.Y.'	[s-ga-nyáda:-es]	repetitive-it.a-lake-long.stative
sa̲hęnada:tré:waht	'they (males) repented'	[sa̲-hęn-ada:t-hré:waht-ø]	repetitive-they(males).a-reflexive-punish-ø.punctual
ęhsgáeyǫˀt	'they (females or mixed group) will bring it back'	[ę-hs-gáe-yǫˀt-ø]	future-repetitive-they(fe/males).a-cause.to.arrive-ø.punctual
sgadę́hda:ˀ	'to resurface something'	[s-ga-dę́hda:ˀ]	repetitive-it.a-lie.spread.out.on.the.ground.stative
ęjisatgánya̲ˀgęˀ	'you will be reimbursed, refunded'	[ę-ji-s-at-gánya̲ˀg-ę-ˀ]	future-repetitive-you(one).a-semireflexive-pay-benefactive-punctual
shonǫ́ˀne:t	'he is behind him, he is next in line'	[s-ho-nǫ́ˀ-ne:t]	repetitive-he.o-head-keep.in.line.stative
ęjijadrihwa̲hsrǫ́:niˀ	'you two will reconcile'	[ę-ji-j-ad-rihw-a̲-hsrǫ́:ni-ˀ]	future-repetitive-you(two).a-semireflexive-matter-joinerA-fix-punctual
sawę́hsga:ˀ	'it spun out, took off with a rattling sound'	[sa-w-ę́hs-ga:-ˀ]	repetitive-it.a-foot-make.a.rattling.noise-punctual
swa̲háhadih	‘the other side of the road’	[j-o̲-háh-adih] repetitive-it.o-road-side.stative, [s-wa̲-háh-adih]	repetitive-it.a-road-side.stative
sganǫ́hsa:t	‘one house’	[s-ga-nǫ́hs-a:-t]	repetitive-it.a-house-joinerA-stand.stative
ganǫ́hsaˀ	‘house’	[ga-nǫ́hs-aˀ]	it.a-house-nsf
swahdáhgwa:t	‘one shoe’	[s-w-ahdáhgw-a:-t]	repetitive-it.a-shoe-joinerA-stand.stative
ahdáhgwaˀ	‘shoes’	[ahdáhgw-aˀ]	shoe-nsf
joyę́hsra:t	‘one blanket’	[s-ga-yę́hsr-a:-t], [j-o-yę́hsr-a:-t]	repetitive-it.o-blanket-joinerA-stand.stative
oyę́hsraˀ	‘blankets’	[o-yę́hsr-aˀ]	it.o-blanket-nsf
jo̲hǫ́na̲ˀda:t	‘one potato’	[s-ga̲-hǫ́na̲ˀd-a:-t], [j-o̲-hǫ́na̲ˀd-a:-t]	repetitive-it.a-potato-joinerA-stand.stative
ohǫ́na̲ˀdaˀ	‘potatoes’	[o-hǫ́na̲ˀd-aˀ]	it.o-potato-nsf
sgatsǫˀ	‘one at a time’; ‘one each’	[s-ga-t-shǫˀ]	repetitive-it.a-stand.stative-pluralizer
sga:t	‘one thing’	[s-ga:-t]	repetitive-it.a-stand.stative
ęsáhshe:t	'count by ones, one by one'	[s-ga-t-shǫˀ] repetitive-it.a-stand.stative-pluralizer [ę-s-áhshe:t-ø]	future-you(one).a-count-ø.punctual
da̲ha:dí:yoˀ	'they came in one by one'	[s-ga-t-shǫˀ] repetitive-it.a-stand.stative-pluralizer [shęh] that [d-a̲-ha:dí:-yo-ˀ]	cislocative-factual-they(males)-arrive-punctual
jo̲hsˀdatsǫ́ˀ	‘a one foot distance’	[j-o̲-hsíˀd-a-t-shǫˀ]	repetitive-it.o-foot-joinerA-stand.stative-pluralizer
jo̲hsíˀda:t	‘one foot’	[j-o̲-hsíˀd-a:-t]	repetitive-it.o-foot-joinerA-stand.stative
todinę̲hę́:dreˀ	'people are standing in a straight line one foot apart'	[j-o̲-hsiˀd-a-t-shǫ́ˀ] repetitive-it.o-foot-joinerA-stand.stative-pluralizer [naˀde-gaǫ-dréˀ] partitive.dualic-they(females or mixed)-apart.stative [t-hodi-nę̲hę́:dreˀ]	cislocative-they(males)-stand.in.line.stative
ganáˀjo̲hkwaˀ	'the bottles are standing one foot apart'	[j-o̲-hsiˀd-a-t-shǫ́ˀ] repetitive-it.o-foot-joinerA-stand.stative-pluralizer [naˀde-gęn-a:dréˀ] partitive.dualic-they(things)-apart.stative [ga-náˀj-o̲-hkwaˀ]	it.a-pail-submerged.stative-instrumental
sga̲ˀdréhdatsǫˀ	‘each car’; ‘one car at a time’	[s-ga̲-ˀdréhd-a-t-shǫˀ]	repetitive-it.a-car-joinerA-stand.stative-pluralizer
sga̲ˀdréhda:t	‘one car’	[s-ga̲-ˀdréhd-a:-t]	repetitive-it.a-car-joinerA-stand.stative
dahsá:dih	'throw it towards me'	[da-hs-á:di-h]	cislocative-you(one).o-throw-ø.aspect
heˀsá:dih	'throw it away from me'	[heˀ-s-á:di-h]	translocative-you(one).o-throw-ø.aspect
tgayę́twa̲hsǫˀ	'it is planted over there'	[t-ga-yę́tw-a̲-hs-ǫˀ]	cislocative-it.a-plant-joinerA-habitual-plural
hegayętwáhsǫˀ	'it is planted over there'	[he-ga-yętw-á-hs-ǫˀ]	translocative-it.a-plant-joinerA-habitual-plural
gayę́twa̲hsǫˀ	'it is planted (here)'	[ga-yę́tw-a̲-hs-ǫˀ]	it.a-plant-joinerA-habitual-plural
dahsá:dih	'throw it to me'	[dah-s-á:di-h]	cislocative-you(one).o-throw-ø.aspect
heˀsá:dih	'throw it away from me'	[heˀ-s-á:di-h]	translocative-you(one).o-throw-ø.aspect
haˀsa:dó:wih	'drive it over there'	[haˀ-s-a:d-ó:wi-h]	translocative-you(one).a-semireflexive-drive-ø.aspect
dasádawę:	'swim this way'	[da-s-ád-awę:-ø]	cislocative-you(one).a-semireflexive-swim-ø.aspect
haˀsádawę:	'swim over there'	[haˀ-s-ád-awę:-ø]	translocative-you(one).a-semireflexive-swim-ø.aspect
desáˀdre:	'drive over here'	[de-sá-ˀdre:-ø]	cislocative-you(one).o-drive-ø.aspect
heˀsáˀdre:	'drive over there'	[heˀ-sá-ˀdre:-ø]	translocative-you(one).o-drive-ø.aspect
tga̲he:ˀ	'it is setting there'	[t-ga̲-he:ˀ]	cislocative-it.a-sitting.on.top.of.stative
heˀgáhe:ˀ	'it is sitting way over there'	[heˀ-gá-he:ˀ]	translocative-it.a-sitting.on.top.of.stative
ga̲he:ˀ	'it is sitting (here)'	[ga̲-he:ˀ]	it.a-sitting.on.top.of.stative
gá:yęˀ	'it is lying'	[gá:-yęˀ]	it.a-lie.stative
tgá:yęˀ	'it is lying there'	[t-gá:-yęˀ]	cislocative-it.a-lie.stative
hegá:yęˀ	'it is lying over there'	[he-gá:-yęˀ]	translocative-it.a-lie.stative
ganí:yǫ:t	'it is hanging'	[ga-ní:yǫ:t]	it.a-hang.stative
tga:ní:yǫ:t	'it is hanging there'	[t-ga:-ní:yǫ:t]	cislocative-it.a-hang.stative
hega:ní:yǫ:t	'it is hanging way over there'	[he-ga:-ní:yǫ:t]	translocative-it.a-hang.stative
gá:deˀ	'it is sticking out'	[gá:-deˀ]	it.a-stick.out.stative
tgá:deˀ	'it is sticking out'	[t-gá:-deˀ]	cislocative-it.a-stick.out.stative
hegá:deˀ	'it is sticking out over there'	[he-gá:-deˀ]	translocative-it.a-stick.out.stative
eˀdrǫˀ	'she is home'	[e-ˀdrǫˀ]	she.a-dwell.stative
gye̲ˀdrǫˀ	'she is at home'	[g-ye̲-ˀdrǫˀ]	cislocative-she.a-dwell.stative
heyéˀdrǫˀ	'she is at home, way over there'	[he-yé-ˀdrǫˀ]	translocative-she.a-dwell.stative
tgayí:	'it is right, correct'	[t-ga-yéi:], [t-ga-yí:]	cislocative-it.a-right.stative
dwagado̲ˀkdá:nih	'I am dissatisfied'	[d-wag-ad-o̲ˀkd-á:ni-h]	cislocative-I.o-semireflexive-finish-benefactive-habitual
itseˀs	'you wander (all the time); you are over there'	[ę:] ‘again’ [tsǫ:] ‘just’ [i-t-s-e-ˀs]	prothetic-cislocative-you(one).a-go-habitual
tgá:gwitgęˀs	'east (direction); the sun rises there'	[t-gá-ragw-itgę-ˀs]	cislocative-it.a-sun-rise-habitual
ętsáˀsęht	'you will bring it down'	[ę-t-s-áˀsęht-ø]	future-cislocative-you(one).a-bring.down-ø.punctual
gyodóˀkda̲ˀǫh	'it is lacking'	[g-yo-d-óˀkda̲ˀ-ǫh]	cislocative-it.o-semireflexive-cause.to.run.out-stative
gyagoya̲ˀdá:gwęh	'she has lost weight'	[g-yago-ya̲ˀd-á:-gw-ęh]	cislocative-she.o-body-joinerA-gather-stative
gyogyę́hdǫh	'the first one, the beginning'	[g-yo-g-yę́hd-ǫh]	cislocative-it.o-semireflexive-hit-stative
dawá:tgri:k	'it pulled back, flinched, shrank'	[d-a-wá:-t-gri-ø-:k]	cislocative-factual-it.a-semireflexive-fold-ø.punctual-modalizer
dawáˀsęˀ	'it dropped, reduced'	[d-a-w-áˀsę-ˀ]	cislocative-factual-it.a-reduce-punctual
tgehdáhkwaˀ	'I believe'	[t-g-ehdáhkw-haˀ]	cislocative-I.a-believe-habitual
ętsadadáhshagwęˀ	'you will remind yourself, make yourself remember'	[ę-t-s-adad-áhshagw-ę-ˀ]	future-cislocative-you(one).a-reflexive-remember-benefactive-punctual
dawáda̲ˀsęht	'it swooped down'	[d-a-w-ád-a̲ˀsęht-ø]	cislocative-factual-it.a-semireflexive-cause.to.drop-ø.punctual
dǫgádo̲ˀktahs	'I was not satisfied (with…)'; 'I did not get enough'	[d-ǫg-ád-o̲ˀkd-a-hsd-ø]	cislocative-factual.I.a-semireflexive-lack-joinerA-cause-habitual
dawatehtgęht	'it went bad'	[d-a-w-at-hehtgęht-ø]	cislocative-factual-it.a-semireflexive-cause.to.go.bad-ø.punctual
ętsa:tró:wiˀ	'you will recount, retell'	[ę-t-s-a:t-hró:wi-ˀ]	future-cislocative-you(one).a-semireflexive-tell-punctual
ętsatsadǫ́:goˀ	'you will unearth it'	[ę-t-s-at-hsadǫ́:-go-ˀ]	future-cislocative-you(one).a-bury-reversive-punctual
ętsa:dó:gęhs	'you will adjust'	[ę-t-s-a:dó:gęhsd-ø]	future-cislocative-you(one).a-make.right-ø.punctual
da:gonhę́hęhih	'she dribbled, peed'	[d-a-ago-nhę́hęhih-ø]	cislocative-factual-she.o-dribble-ø.punctual
dagayagę́hdahk	'it came out suddenly'	[da-ga-yagę́hd-a-ø-hk]	cislocative-it.a-issue.from-joinerA-ø.punctual-former
daję́:na:	'grab it!'	[da-j-ę́:na:-ø]	cislocative-you(one).a-grab-ø.aspect
hę́:goh	'I will dip it in, submerge it'	[h-ę́:-g-oh-ø]	translocative-future-I.a-dip.in.liquid-ø.punctual
hegáhgwęˀs	'to the setting sun, the direction of the sunset, west'	[he-gá-hgwę-ˀs]	translocative-it.a-set-habitual
hęhsye:ˀ	'you will touch'	[h-ę-hs-ye:-ˀ]	translocative-future-you(one).a-touch-punctual
hęhsyáhnǫ:ˀ	'you will grope, touch, pick at'	[h-ę-hs-yá-hnǫ:-ˀ]	translocative-future-you(one).a-touch-distributive-punctual
hęgǫ́:nęht	'I will swallow'	[h-ę-g-ǫ́:nęht-ø]	translocative-future-I.a-swallow-punctual
heyótsˀahdǫh	'it is all gone'	[he-yó-tsˀahd-ǫh]	translocative-it.o-dwindle-stative
hęhsó:goht	'you will exaggerate, go above and beyond'	[h-ę-hs-ó:goht-ø]	translocative-future-you(one).a-surpass-ø.punctual
hęwáˀsęˀ	'it will fall in'	[h-ę-w-áˀsę-ˀ]	translocative-future-it.a-fall.in-punctual
hęgǫyadę́:nyeht	'I will refer you (to someone else)'	[h-ę-gǫy-adę́:-nyeht-ø]	translocative-future-i:you-send-punctual
hé:yoht	'suddenly'	[to:] that [hé:-yo-ht]	translocative-it.o-resemble.stative
hęhsadagwáihsaht	'you will go straight’	[h-ę-hs-ad-agwáihsaht-ø]	translocative-future-you(one).a-semireflexive-straighten-ø.punctual
heyó:gęˀt	'it is transparent'	[he-yó:-gęˀt]	translocative-it.o-transparent.stative
haˀhoˀnigǫ́haˀehs	'his mind settled on'	[h-aˀ-ho-ˀnigǫ́h-a-ˀehsd-ø]	translocative-factual-he.o-mind-joinerA-cause.to.hit-ø.punctual
hęsagya̲ˀdǫ́:diˀ	'you will pounce on it'	[h-ę-s-ag-ya̲ˀd-ǫ́:di-ˀ]	translocative-future-you(one).o-semireflexive-body-throw-punctual
hęhaihwę́hę:ˀ	'he will take the message'	[h-ę-ha-ihw-ę́hę:-ˀ]	translocative-future-he.a-matter-convey-punctual
hękre:k	'I will push it'	[h-ę-k-hre:k-ø]	translocative-future-i-push-ø.punctual
hęgóˀkdęˀ	'I will finish something'	[h-ę-g-óˀkd-ęˀ]	translocative-future-I.a-finish-punctual
tagihnǫ:s	'he is calling me’	[t-hag-ihnǫ:k-s]	cislocative-he:me-call-habitual
hęgihnǫ:k	'I will call'	[h-ę-g-ihnǫ:k-ø]	translocative-I.a-call-ø.punctual
tgya̲hsǫ́haˀ	'I call them'; 'I am a bingo caller'	[t-g-ya̲hsǫ́-haˀ]	cislocative-I.a-name-habitual
hęhshéyahsǫ:ˀ	'you will call someone's name (over there)'	[h-ę-hshé-yahsǫ:-ˀ]	translocative-future-you:them-name-punctual
ętsyáˀdęˀ	'Wait, you'll fall into it'	[waˀjih] wait [ę-t-s-yáˀd-ę-ˀ]	future-cislocative-you(one).a-body-fall-punctual
hewagya̲ˀdę́ˀǫh	'I have fallen into it'	[he-wag-ya̲ˀd-ę́-ˀǫh]	translocative-I.o-body-fall-stative
tgegówanęh.	‘I amthe oldest (biggest)’	[í:ˀ] I [t-g-e-gówan-ęh]	cislocative-I.a-joinerE-big-stative
gegówanęh	‘I ambig’	[g-e-gówan-ęh]	I.a-joinerE-big-stative
tganǫ́hso:t	‘at the house’	[shęh] that [t-ga-nǫ́hs-o:t]	cislocative-it.a-house-stand.stative
haˀdewę̲hníhsrage:	‘every day’, ‘many days’	[haˀde-w-ę̲hníhsr-age:]	translocative.dualic-it.a-day-two.or.more.stative
haˀdewa̲hsǫ́dage:	‘every night’	[haˀde-w-a̲hsǫ́d-age:]	translocative.dualic-it.a-night-two.
haˀdega̲ˀdréhdage:	‘all kinds of cars’	[haˀde-ga̲-ˀdréhd-age:]	translocative.dualic-it.a-car-two.or.more.stative
dekdaˀs	'I amstanding'	[de-k-d-a-ˀs]	dualic-I.a-stand-join-habitual
dęhadagyáˀda̲hgwaˀt	'he will do push ups'	[d-ę-ha-dag-yáˀd-a̲-hgwaˀt-ø]	dualic-future-he.a-reflexive-body-joinerA-cause.to.raise-ø.punctual
degaǫnáˀsgwa̲hkwaˀ	'they (females or mixed) are jumping'	[de-gaǫ-náˀsgw-a̲-hgw-haˀ]	dual-they(fe/males).a.semireflexive-lift.up-habitual
de̲hęnáǫhaˀ	'they (males) are racers'	[de̲-hęn-áǫ-haˀ]	dualic-they(males).a-run-habitual
de̲hęnadátgǫ̲he:s	'boxers'; 'they (males only) are boxing'	[de̲-hęn-adát-gǫ̲he:g-s]	dualic-they(males).a-reflexive-punch-habitual
dewá:tgwęh	'it is dancing'	[de-w-á:t-gw-ęh]	dualicit.ait-semireflexive-dance-stative
da:há:dahs	'he should stop'	[d-a:-há:-dahsd–ø]	dualic-indefinite-he.a-stop-ø.aspect
dehsdaˀ	'stop!'	[de-hs-daˀ-ø]	dualic-you(one).a-stop-ø.aspect
dęgakeyáˀdahk	'I will pick them up'	[d-ę-gake-yáˀd-a-hgw-ø]	dualic-future-I:them-body-joinerA-pick.up-ø.punctual
dęwátahahk	'it will walk'	[d-ę-w-át-hah-a-hgw-ø]	dualic-future-it.a-semireflexive-road-joinerA-pick.up-ø.punctual
deyagodáwęnyeˀ	'she is walking about'	[de-yago-d-áwęnye-ˀ]	dualic.she.o-semireflexive-stir-stative
dęhahgwadáhnǫ:ˀ	'he will raise or lift things up’	[d-ę-ha-hgwad-á-hnǫ-:ˀ]	dualic-future-he.a-raise.up-joinerA-distributive-punctual
detodinę́hędreˀ	'they are standing (or guarding)'	[de-t-hodi-nę́hę-dr-e-ˀ]	dualic-cislocative-they(males).o-stand.in.a.line-dislocative-go-stative
degóno̲hsgwihs	'I am sweeping'	[de-g-ó-no̲hsgwi-hs]	dualic-I.a-semireflexive-sweep-habitual
deyoˀnhęhtsę́dǫ̲hǫh	'it is wagging its tail'	[de-yo-ˀnhęhts-ę́dǫ̲h-ǫh]	dual-it.o-tail-shake-stative
dewahji̲ˀdóha:s	'pliers'	[de-w-ahji̲ˀd-óha:g-s]	dual-it.a-hand-squeeze-habitual
degaǫdóhda:s	'janitors'	[de-gaǫ-d-óhda:g-s]	dual-they(fe/males).a-semireflexive-clean-habitual
de̲há:yaˀs	'he breaks it'	[de̲-há:-yaˀg-s]	dual-he.a-break-habitual
degaihó:węhs	'computer'	[de-ga-ih-ó:wę-hs]	dualic-it.a-words-split-habitual
degáhihtaˀ	'grinder or cutter'	[de-gá-hriht-haˀ]	dualic-it.a-chop.up-habitual
degawidrágędrǫhs	'cream separator'	[de-ga-widr-á-gędrǫ-hs]	dualic-it.a-ice-joinerA-skim.off-habitual
deyohahíya̲ˀgǫh	'crossroad'	[de-yo-hah-íya̲ˀg-ǫh]	dualic-it.o-road-cross-stative
deyótsaˀkdǫh	'it is bent'	[de-yó-tsaˀkd-ǫh]	dualic-it.o-bend-stative
degáhǫˀ	'it is lying across'	[de-gá-hǫˀ]	dualic-it.a-lie.across.stative
dęjidwadatnǫ̲hǫ́:nyǫ:ˀ	'we will greet each other again'	[d-ę-ji-dwa-dat-nǫ̲hǫ́:nyǫ-:ˀ]	dualic-future-we.all.inclusive.a-reflexive-greet-punctual
degaˀęnáęhęˀ	'I am a snowsnake player'	[de-g-aˀęn-á-ę-hęˀ]	dualic-I.a-pole-joinerA-hit-habitual
degáhshętwahs	'I am crying'	[de-g-áhshętw-a-hs]	dualic-I.a-cry-joinerA-habitual
deyóhsdateh	'it is smooth'	[de-yó-hsd-ateh]	dualic-it.o-shiny.object-clear.stative
dewátęho:t	'pile of wood'	[de-wá-t-hęh-o:t]	dualic-it.a-semireflexive-wood-stand.stative
dehsgwę́ˀnya:ˀ	'you who watch over us'	[de-hsgw-ę́-ˀny-a:ˀ]	dualic-you:us-semireflexive-hand-hold.stative
desaˀdráihęh	'hurry!'	[de-sa-ˀdráihęh-ø]	dualic-you(one).o-hurry-ø.aspect
dehsade-smack	'smack your lips!'	[de-hs-ad-e-smack-ø]	dualic-you(one).a-semireflexive-epen-smack-ø.punctual
atho:-stro:k	'he had a stroke'	[a-t-ho:-stro:k-ø]	factual-dualic-he.o-stroke-ø.punctual
deyagode-highlight-ǫh	'where she has it highlighted'	[de-yago-d-e-highlight-ǫh]	dualic-she.o-semireflexive-epen-highlight-stative
degadiyáhshesǫˀ	‘two things each, at a time’	[de-gadi-yáhshe-shǫˀ]	dualic-they(things)-two.living.things.stative-pluralizer
daga:dí:yoˀ	'they (things, i.e., cars) came in two at a time'	[de-gadi-yahshe-shǫˀ] dualic-they(things)-certain.number.stative-pluralizer [shęh] that [d-a-ga:dí:-yo-ˀ]	cislocative-factual-they(things)-arrive-punctual
degajihsdá:ge:	‘two lamps’	[de-ga-jihsd-á:ge:]	dualic-it.a-lamp-be.two.or.more.stative
deyohsi̲ˀdá:ge:	‘two feet’	[de-yo-hsi̲ˀd-áge:]	dualic-it.o-foot-be.two.or.more.stative
deyonǫ̲hsá:ge:	‘two eggs’	[de-yo-nǫ̲hs-á:ge:]	dualic-it.o-egg-be.two.or.more.stative
dewahda̲hgwá:ge:	‘two shoes’	[de-w-ahda̲hgw-á:ge:]	dualic-it.a-shoe-be.two.or.more.stative
degaˀdre̲hdage̲há:gyeˀ	‘two cars at at time’	[de-ga-ˀdre̲hd-age̲-h-á:-gy-e-ˀ]	dualic-it.a-car-two.or.more.stative-pronunciation.h-joiner.A-progressive-go-stative
deyó:gę:	‘it is between’, ‘in the middle’	[de-y-ó:gę:]	dualic-it.o-between.stative
dędwadathró:wiˀ	'we all will tell one another'	[d-ę-dw-adat-hró:wi-ˀ]	dualic-future-we.all.inclusive.a-reflexive-tell-punctual
ędwa:thró:wiˀ	'we all (incl.) will tell'	[ę-dwa:-t-hró:wi-ˀ]	future-we.all.inclusive.a-semireflexive-tell-punctual
ękehó:wiˀ	'I will tell someone'	[ę-ke-hó:wi-ˀ]	future-i:her-tell-punctual
ęsadwahátaˀt	'you will dry out the meat'	[ę-s-ad-ˀwah-á-taˀt]	future-you(one).a-semireflexive-meat-dry.out-ø.punctual
awadadwę́:deht	‘it (e.g. a pet) forfeited (its life)’	[a-w-adad-wę́:deht]	factual-it.a-reflexive-forfeit-ø.punctual
ęhsade̲ˀsgǫ́:dęˀ	'you will roast something'	[ę-hs-ade̲-ˀsg-ǫ́:dę-ˀ]	future-you(one).a-semireflexive-joinerE-roast-put.in-punctual
ahadadéˀo:k	‘he axed himself’	[a-h-adad-é-ˀo:k]	factual-he.a-reflexive-joinerE-axe-ø.punctual
ǫdéteˀtra:s	'she is powdering herself'	[ǫ-d-é-teˀt-ra:s]	she.a-semireflexive-joinerE-powder-spread-ø.punctual
ǫdade̲ˀgę́:ˀęh	‘her younger sister’	[ǫ-dad-e̲-ˀgę́:ˀęh]	she.a-reflexive-joinerE-younger.sister.stative
ǫdǫ́:nyeˀs	'she is breathing'	[ǫ-d-ǫ́:nye-ˀs]	she.a-semireflexive-breathe-habitual
aˀǫdadahǫ́:dǫ:ˀ	‘she asked her’	[aˀ-ǫ-dad-ahǫ́:dǫ:-ˀ]	factual-she.a-reflexive-ask-punctual
sagyaˀdo̲hái	'take a bath'	[s-ag-yaˀd-o̲hái]	you(one).a-reflexive-body-wash-ø.aspect
ęhsadagyé:na:ˀ	‘you will wrestle’	[ę-hs-adag-yé:na:-ˀ]	future-you(one).a-reflexive-catch-punctual
satgǫhso̲hái	'wash your face'	[s-at-gǫhs-o̲hái]	you(one).a-semireflexive-face-wash-ø.aspect
agadadé:gęˀ	‘I saw myself’	[a-g-ádat-gę-ˀ], [a-g-adad-é:-gę-ˀ]	factual-I.a-reflexive-joinerE-see-punctual
agadadé:gęˀ	'I saw myself'	[a-g-adad-é:-gę-ˀ]	factual-I.a-reflexive-joinerE-see-punctual
agé:gęˀ	'I saw (it)'	[a-g-é-gę-ˀ]	factual-I.a-joinerE-see-punctual
ahé:gęˀ	'I saw him'	[a-hé:-gę-ˀ]	factual-I:him-see-punctual
dedwadagyénawaˀs	'let us all help one another'	[de-dw-adag-yénawaˀs-ø]	dualic-we.all-reflexive-help-ø.aspect
dwayénawaˀs	'let all of us help (it)'	[dwa-yénawaˀs-ø]	we.all-help-ø.aspect
dędwadathró:wiˀ	'we all will tell one another'	[d-ę-dw-adat-hró:wi-ˀ]	dual-future-we.all.inclusive.a-reflexive-tell-punctual
ędwa:thró:wiˀ	'we all will tell'	[ę-dw-a:t-hró:wi-ˀ]	future-we.all.inclusive.a-semireflexive-tell-punctual
dęgaǫdagyená:waˀs	'they (f/m) will help each other'	[d-ę-gaǫ-dag-yená:waˀs-ø]	dualic-future-they(fe/males).a-reflexive-help-ø.punctual
ęgǫyená:waˀs	'I will help you'	[ę-gǫ-yená:waˀs-ø]	future-i:you-help-ø.punctual
degaǫdatgǫ̲hsóhae	'they are washing each other's faces'	[de-gaǫ-dat-gǫ̲hs-óhae]	dual-they(fe/males).a-reflexive-face-wash.stative
shagogǫ̲hsóhae	'he is washing her face'	[shago-gǫ̲hs-óhae]	he:her-face-wash.stative
agaeyé:na:ˀ	'they caught, received, accepted it'	[a-gae-yé:na:-ˀ]	factual-they(fe/males).a-catch-punctual
wadatgowá:nęh	'it is rash, unwise, self-important, egotistical'	[w-adat-gowá:n-ęh]	it.a-reflexive-big-stative
hadágya̲ˀda:s	'he has a high opinion of himself, he is self-centred, he is bold'	[ha-dág-ya̲ˀda:-s]	he.a-reflexive-rely.on-habitual
wadatnigǫ́ha:ˀ	'it is wary, cautious'	[w-adat-ˀnigǫ́ha:ˀ]	it.a-reflexive-watch.habitual
tęwadadǫ́:niˀ	'it will emerge or appear unintentionally'; 'it will do it by itself'	[t-h-ę-w-adad-ǫ́:ni-ˀ]	contrastive-translocative-future-it.a-reflexive-make-punctual
dęsádadǫˀ	'you will trade, exchange'	[d-ę-s-ádad-ǫ-ˀ]	dualic-future-you(one).a-reflexive-give-punctual
desadadéhsnyeh	'tidy up!’ ‘groom yourself!'	[de-s-adad-é-hsnye-h]	dualic-you(one).a-reflexive-joinerE-care.for-ø.aspect
ęhsadagyé:na:ˀ	'you will wrestle'	[ę-hs-adag-yé:na:-ˀ]	future-you(one).a-reflexive-catch-punctual
dęhsádatsˀa:ˀ	'you will quarrel'	[d-ę-hs-ádat-sˀa:-ˀ]	dualic-future-you(one).a-reflexive-use.up-punctual
dędwadadrihwanǫ́hkwa:k	'we all will show respect for one another'	[d-ę-dwa-dad-rihw-a-nǫ́hkw-a-ø-:k]	dualic-future-we.all.inclusive.a-reflexive-matter-joinerA-respect-joinerA-ø.punctual-modalizer
de̲hęnadátgǫ̲he:s	'boxers'; 'they (males) are boxing'	[de̲-hęn-adát-gǫ̲he:g-s]	dualic-they(males).a-reflexive-punch-habitual
sa̲hęnada:thré:waht	'they (males) repented'	[sa̲-hęn-ada:t-hré:waht-ø]	repetitive-they(males).a-reflexive-punish-ø.punctual
awadadrí:yoˀ	'it killed itself'; 'suicide'	[a-w-adad-rí:yo-ˀ]	factual-it.a-reflexive-kill-punctual
ęhsadadrohé:gęˀ	'you will accumulate (things, ideas, etc.) for yourself'	[ę-hs-adad-rohé:g-ę-ˀ]	future-you(one).a-reflexive-gather-benefactive-punctual
ǫdadri̲hǫ́nyanih	'she is reading'	[ǫ-dad-ri̲h-ǫ́ny-a-nih]	she.a-reflexive-word-make-joinerA-benefactive.habitual
agadadwíya̲hdǫˀt	'I had an abortion'	[a-g-adad-wíy-a̲hdǫˀt-ø]	factual-I.a-reflexive-offspring-cause.to.disappear-ø.punctual
dęgaǫdagya̲ˀdáhgwaˀt	'they (females or mixed) will do push ups'	[d-ę-gaǫ-dag-ya̲ˀd-áhgwaˀt-ø]	dualic-future-they(fe/males).a-reflexive-body-lift.up-ø-punctual
hatgǫhso̲háe	'he is washing his face'	[ha-t-gǫhs-o̲háe]	he.a-semireflexive-face-wash.habitual
shagogǫ̲hsóhae	'he is washing her face'	[shago-gǫ̲hs-óhae]	he:her-face-wash.habitual
ęgáhseht	'I will hide something'	[ę-g-áhseht-ø]	future-I.a-hide-ø.punctual
dędwadęnǫ́hǫnyǫ:ˀ	'we will give thanks'	[d-ę-dw-adę-nǫ́hǫnyǫ-:ˀ]	dualic-future-we.all.inclusive.a-semireflexive-thank-punctual
ędwa:thró:wiˀ	'we will tell, narrate'	[ę-dw-a:t-hró:wi-ˀ]	future-we.all.inclusive.a-semireflexive-tell-punctual
dędwanǫ̲hǫ́:nyǫ:ˀ	'we will thank it'	[d-ę-dwa-nǫ̲hǫ́:nyǫ-:ˀ]	dualic-future-we.all.inclusive.a-thank-punctual
dęhshenǫ̲hǫ́:nyǫ:ˀ	'you will welcome, greet or thank someone'	[d-ę-hshe-nǫ̲hǫ́:nyǫ-:ˀ]	dualic-future-you:her-thank-punctual
dęgaǫdagyená:waˀs	'they (f/m) will help each other'	[d-ę-gaǫ-dag-yená:waˀs-ø]	dualic-future-they(fe/males).a-reflexive-help-ø.punctual
hadęyenáwa̲ˀseh	'he is a helper, assistant'	[h-adę-yenáwa̲ˀs-eh]	he.a-semireflexive-help-habitual
gaǫdęyenawáˀseh	'they (f/m) are helpers, assistants of hers'	[gaǫ-dę-yenawáˀs-eh]	they(fe/males).a-semireflexive-help-habitual
ęgǫyena:waˀs	'I will help you'	[ę-gǫ-yena:waˀs-ø]	future-i:you-help-ø.punctual
agaǫtgwé:niˀ	‘they won’	[a-gaǫ-t-gwé:ni-ˀ]	factual-they(fe/males).a-semireflexive-succeed-punctual
agaegwé:niˀ	‘they are or were able to do it’	[a-gae-gwé:ni-ˀ]	factual-they(fe/males).a-succeed-punctual
agaǫdatgwé:niˀ	'they beat her'	[a-gaǫ-dat-gwé:ni-ˀ]	factual-they(fe/males).a-reflexive-succeed-punctual
hadęhní:nǫh	'he is a seller or storekeeper'	[h-adę-hní:nǫ-h]	he.a-semireflexive-buy-habitual
hahní:nǫh	'he is a buyer'	[ha-hní:nǫ-h]	he.a-buy-habitual
agadekǫ́:ni:	'I am eating'	[ag-ad-e-k-ǫ́:ni-:]	I.o-semireflexive-joinerE-food-make-stative
age:kǫ́:ni:	'I am cooking’	[ag-e:-k-ǫ́:ni-:]	I.o-joinerE-food-make-stative
ga̲hǫwadíhǫh	‘a leaning boat’	[ga̲-hǫw-adíh-ǫh]	it.a-boat-side-stative
ga̲hǫ́:waˀ	‘boat’	[ga̲-hǫ́:w-aˀ]	it.a-boat-nsf
wadíhǫh	‘it is leaning’	[w-adíh-ǫh]	it.a-side-stative
niyohahú:ˀuh	‘a small road’	[ni-yo-hah-ú:ˀuh]	partitive-it.o-road-small.stative
oháhaˀ	‘road’	[o-háh-aˀ]	it.o-road-nsf
niwú:ˀuh	‘it is small’	[ni-w-ú:ˀuh]	partitive-it.a-small.stative
gayę́hsraęˀ	‘a blanket lying on the ground’	[ga-yę́hsr-a-ęˀ]	it.a-blanket-joinerA-lie.stative
gá:yęˀ	‘it is lying on the ground’	[gá:-yęˀ]	it.a-lie.stative
gayęhsraní:yǫ:t	‘a hanging blanket’	[ga-yęhsr-a-ní:yǫ:t]	it.a-blanket-joinerA-hang.stative
ganí:yǫ:t	‘it is hanging’	[ga-ní:yǫ:t]	it.a-hang.stative
gayęhsradę́hda:ˀ	‘a blanket lying spread out on the ground’	[ga-yęhsr-a-dę́hda:ˀ]	it.a-blanket-joinerA-lie.spread.out.on.ground.stative
gadę́hda:ˀ	‘it is lying spread out on the floor or the ground’	[ga-dę́hda:ˀ]	it.a-lie.spread.out.on.ground.stative
oyęhsrowá:nęh	‘a big blanket’	[o-yęhsr-owá:n-ęh]	it.o-blanket-big-stative
gowá:nęh	‘it is big’	[g-owá:n-ęh]	it.a-big-stative
oyę́hsrase:	‘a new blanket’	[o-yę́hsr-ase:]	it.o-blanket-new.stative
oyęhsragá:yǫh	‘an old blanket’	[o-yęhsr-a-gá:y-ǫh]	it.o-blanket-joinerA-old-stative
ogá:yǫh	‘it is old’	[o-gá:y-ǫh]	it.o-old-stative
oyę́hsratgiˀ	‘an ugly blanket’	[o-yę́hsr-a-tgiˀ]	it.o-blanket-joinerA-ugly.stative
otgiˀ	‘it is ugly’	[o-tgiˀ]	it.o-ugly.stative
ahawiyánę̲hsgoˀ	‘he kidnapped a child’	[a-ha-wiy-á-nę̲hsgo-ˀ]	factual-he.a-offspring-joinerA-steal-punctual
owí:yaˀ	‘offspring’	[o-wí:y-aˀ]	it.o-offspring-nsf
ęhánę̲hsgoˀ	‘he will steal’	[ę-há-nę̲hsgo-ˀ]	future-he.a-steal-punctual
ęhsadęnáˀtranǫ:t	‘we'll give you food’	[ę-hs-adę-náˀtr-a-nǫ:t-ø]	future-you(one).a-semireflexive-snack-joinerA-feed-punctual
sadę́na̲ˀtraˀ	‘your food’	[s-adę́-na̲ˀtr-aˀ]	you(one).o-semireflexive-snack-nsf
hohsíˀdatgiˀ	‘his feet are dirty’	[ho-hsíˀd-a-tgiˀ]	he.o-foot-joinerA-dirty.stative
hahsíˀdaˀgeh	‘on his foot’	[ha-hsíˀd-a̲ˀgeh]	he.a-foot-on
otgiˀ	‘it is dirty or ugly’	[o-tgiˀ]	it.o-dirty.stative
ęknóhaeˀ	‘I will wash it’	[ę-k-n-óhae-ˀ]	future-I.a-noun-wash-punctual
ęgahjo̲háeˀ	‘I will wash my hands’	[ę-g-ahj-o̲háe-ˀ]	future-I.a-hand-wash-punctual
onáˀnawę:	‘it is wet, melted, moist’	[o-náˀ-nawę:]	it.o-noun-moist.stative
ohehdaná:wę:	‘wet, moist dirt, earth’	[o-hehd-a-ná:wę:]	it.o-earth-joinerA-moist.stative
gyo̲ˀsę́ˀǫh	‘it has fallen off something’	[g-yo̲-ˀs-ę́ˀ-ǫh]	cislocative-it.o-noun-fall-stative
heyohnegę́ˀǫh	‘falling water’	[he-yo-hneg-ę́ˀ-ǫh]	translocative-it.o-water-fall-stative
dewakdo̲há:gǫh	‘I am squeezing it’	[de-wak-d-o̲há:g-ǫh]	dualic-I.o-noun-squeeze-stative
ęhsehsrǫ́:niˀ	‘you will create, make something’	[ę-hs-e-hsr-ǫ́:ni-ˀ]	future-you(one).a-joinerE-noun-make-punctual
sa̲ˀahdrǫ́:nih	‘you make baskets’	[sa̲-ˀahdr-ǫ́:ni-h]	you(one).o-basket-make-stative
gahnyo:t	‘it is standing’	[ga-hn-yo:t]	it.a-noun-stand.stative
gajísdo:t	‘a light’	[ga-jísd-o:t]	it.a-light-stand.stative
gajobtrowá:nęh	‘big job’	[ga-job-tr-owá:n-ęh]	it.a-job-big-stative
gajobtrí:yo:	‘nice job’	[ga-job-tr-í:yo:]	it.a-job-nominalizer-good.stative
aknáhsgwaęˀ	‘I have a dog’	[so:wá:s] dog [ak-náhsgw-a-ęˀ]	I.o-domestic.animal-joinerA-have.stative
sgra̲héˀda:t	‘one tree’	[s-gra̲héˀd-a:-t]	repetitive-it.tree-joinerA-stand.stative
ga̲hnih	‘it is barking’	[ga̲-hni-h]	it.a-bark-habitual
gadá:węh	‘I am swimming’	[g-ad-á:wę-h]	it.a-semireflexive-swim-habitual
saˀé:yǫˀ	‘she returned’	[s-aˀ-é:-yǫ-ˀ]	repetitive-factual-she.a-arrive-punctual
haˀgáhge:t	‘I stopped by there’	[haˀ-g-áhge:t-ø]	translocative-I.a-stop.in-ø.punctual
agiˀ	‘I said’	[a-g-i-ˀ]	factual-I.a-say-punctual
agatgǫ̲hsóhaeˀ	‘I washed my face’	[a-g-at-gǫ̲hs-óhae-ˀ]	factual-I.a-semireflexive-face-wash-punctual
gegǫ́hsa̲ˀgeh	‘on my face’	[g-e-gǫ́hs-a̲ˀgeh]	I.a-joinerE-face-on
agatnu̲ˀtsóhaeˀ	‘I brushed my teeth’	[a-g-at-nu̲ˀts-óhae-ˀ]	factual-I.a-semireflexive-tooth-wash-punctual
knuˀtsáˀgeh	‘on my teeth’	[k-nuˀts-áˀgeh]	I.a-tooth-on
agęhsi̲ˀdóhaeˀ	‘I washed my feet’	[a-g-ęhsi̲ˀd-óhae-ˀ]	factual-I.a-foot-wash-punctual
gę̲hsíˀda̲ˀgeh	‘on my foot’	[g-ę̲hsíˀd-a̲ˀgeh]	I.a-foot-on
agǫ́ya̲hsha:ˀ	‘I thought of you’	[í:hs] you [a-gǫ́y-a̲hsha:-ˀ]	factual-i:you-remember-punctual
ętsadadáhshagwęˀ	‘you will remind yourself, make yourself remember’	[ę-t-s-adad-áhshagw-ę-ˀ]	future-cislocative-you(one).a-reflexive-remember-benefactive-punctual
ęhéhsnǫdręˀ	‘you will follow him’	[ę-héhs-hnǫdrę-ˀ]	future-you:him-follow-punctual
oˀgráęˀ	‘snow lying there’; ‘fallen snow’	[o-ˀgr-á-ęˀ]	it.o-snow-lie.stative
oˀgraˀ	‘snow’	[o-ˀgr-aˀ]	it.o-snow-nsf
nigá:yęˀ	‘where it is lying’	[ni-gá:-yęˀ]	partitive-it.a-lie.stative
gayęhsradę́hda:ˀ	‘blanket lying spread out’	[ga-yęhsr-a-dę́hda:ˀ]	it.a-blanket-joinerA-lie.spread.out.on.ground.stative
gayę́hsraˀ	‘blanket’	[ga-yę́hsr-aˀ]	it.a-blanket-nsf
gadę́hda:ˀ	‘it is lying spread out’	[ga-dę́hda:ˀ]	it.a-lie.spread.out.on.ground.stative
ohǫna̲ˀdáhsi̲ha:ˀ	‘potatoes standing in a group’	[o-hǫna̲ˀd-á-hsi̲ha:ˀ]	it.o-potato-joinerA-stand.in.group.stative
ohǫ́na̲ˀdaˀ	‘potato’	[o-hǫ́na̲ˀd-aˀ]	it.o-potato-nsf
gáehsi̲ha:ˀ	‘they (females or mixed) are standing in a group or clump’	[gáe-hsi̲ha:ˀ]	they(fe/males).a-stand.in.a.group.stative
ohyajiwá:gę:	‘tart, sour fruit’	[o-hy-a-jiwá:gę:]	it.o-fruit-joinerA-sour.stative
ojíwagę:	‘it is sour, salty, bitter’	[o-jíwagę:]	it.o-sour.stative
ohyága̲ˀǫh	‘good-tasting fruit’	[o-hy-á-ga̲ˀ-ǫh]	it.o-fruit-joinerA-good.tasting-stative
ogáˀǫh	‘it tastes good’	[o-gáˀ-ǫh]	it.o-good.tasting-stative
ohyówanęh	‘big fruit’	[o-hy-ówan-ęh]	it.o-fruit-big-stative
gagówanęh	‘it is big’	[ga-gówan-ęh]	it.a-big-stative
niyohyú:ˀuh	‘small fruit’	[ni-yo-hy-ú:ˀuh]	partitive-it.o-fruit-small.stative
niwú:ˀuh	‘how small it is’	[ni-w-ú:ˀuh]	partitive-it.a-small.stative
wahyaniyǫ́:taˀ	‘hanging fruit’	[w-ahy-a-niyǫ́:t-haˀ]	it.a-fruit-joinerA-hang-habitual
ganí:yǫ:t	‘it is hanging’	[ga-ní:yǫ:t]	it.a-hang.stative
ohyá:jih	‘dark fruit’	[o-hy-á:-jih]	it.o-fruit-joinerA-dark.stative
ga̲hǫ́ˀjih	‘it is dark’	[ga̲-hǫ́ˀ-jih]	it.a-noun-dark.stative
otgę:	‘it is spoiled, rotten’	[o-tgę:]	it.o-rotten.stative
ohyáih	‘ripe fruit’	[o-hy-á-ih]	it.o-fruit-joinerA-ripe.stative
ęwáhyaiˀ	‘it will ripen’	[ę-w-áhy-a-i-ˀ]	future-it.a-fruit-joinerA-ripen-punctual
agǫgwe̲ˀdí:yo:	‘nice person’	[ag-ǫgwe̲ˀd-í:yo:]	she.o-person-nice.stative
gaihoˀdęhsrí:yo:	‘nice work’	[ga-ihoˀdęhsr-í:yo:]	it.a-work-nice.stative
ga̲há:do:t	‘a forest’	[ga̲-há:d-o:t]	it.a-forest-stand.stative
odrǫ́hyo:t	‘sunbeam, ray of light, sunshine’	[o-drǫ́hy-o:t]	it.o-ray.of.light-stand.stative
agatgǫ̲hsóhaeˀ	‘I washed my face’	[a-g-at-gǫ̲hs-óhae-ˀ]	factual-I.a-semireflexive-face-wash-punctual
agęhsi̲ˀdóhaeˀ	‘I washed my feet’	[a-g-ęhsi̲ˀd-óhae-ˀ]	factual-I.a-foot-wash-punctual
honadahsehdǫ̲hǫ́:gyeˀs	‘they (m) are sneaking around’	[hon-ad-ahsehd-ǫ̲h-ǫ́:gy-e-ˀs]	they(males).o-semireflexive-hide-stative-progressive-go-habitual.
otgę́ˀseht	'it is nice to see, interesting'	[o-t-gę-ˀse-ht]	it.o-semireflexive-see-plural-causative
hoˀdaiháˀseh	'he is too hot'	[ho-ˀdaih-áˀse-h]	he.o-hot-plural-habitual
dewagadawęnyáˀseh	'I amconfused and doubtful'	[de-wag-ad-awęny-áˀse-h]	dualic-I.o-semireflexive-stir,mix-pluralizer-habitual
deyagodawęnyeˀ	‘she is walking about’	[de-yago-d-awęny-eˀ]	dualic-she.a-stir,mix-stative
gaǫdagyenawáˀseh	'they (females or mixed) help her'	[gaǫ-dag-yenaw-áˀse-h]	they(f/m).reflexive.catch.plural-habitual
agaǫda:gyé:na:ˀ	'they (females or mixed) caught her'	[a-gaǫ-da:g-yé:na:-ˀ]	factual-they(f/m)-reflexive-catch-punctual
a:gakeyatgę́ˀse:ˀ	'I should watch them'	[a:-gakey-at-gę́-ˀse-:ˀ]	indefinite-I:them-semireflexive-see-plural-punctual
haˀǫ́tgę̲ˀse:ˀ	'she is watching over there'	[haˀ-ǫ́-t-gę̲-ˀse-:ˀ]	there-she.a-see-plural-punctual
hahę́:dǫ:	'he is the front, the leader'	[ha-hę́:dǫ-:]	he.a-lead-stative
ęhsáhsha̲ˀse:k	'you will remember'	[ę-hs-áhsha-ˀse-:k]	future-you(one).o-remember-pluralizer-modalizer
ęgagyǫ̲ˀséhaˀ	'I am going to go and visit'	[ę-g-ag-yǫ̲-ˀsé-h-aˀ]	future-I.a-semireflexive-arrive-plural-dislocative-punctual
agagyǫ̲ˀséhe-ˀ	'I am going to go visit'	[ę-g-ag-yǫ̲-ˀsé-h-e-ˀ]	future-I.a-semireflexive-arrive-plural-dislocative-go-punctual
tsǫ:	'he is a live-in'	[ho-g-yǫ-ˀsé-:]	he.o-semireflexive-arrive-plural-stative
agatowínyǫ̲ˀse:	‘I have a cold’	[ag-atow-inyǫ-ˀse-:]	I.o-cold-distributive-pluralizer-stative
adwagagyáǫnyǫˀs	‘I had a vision’; ‘I got spooked’	[ad-wag-ag-ya-ǫ-nyǫ-ˀs]	factual.dualic-I.o-semireflexive-otherness-distributive-distributive-pluralizer
ohona̲ˀdí:yoˀs	'nice potatoes'	[o-hona̲ˀd-í:yo-ˀs]	it.o-potato-good.stative-pluralizer
ohona̲ˀdí:yo:	'nice potato'	[o-hona̲ˀd-í:yo:]	it.o-potato-good.stative
ohǫna̲ˀdówanęˀs	'big potatoes'	[o-hǫna̲ˀd-ówan-ę-ˀs]	it.o-potato-big-stative-pluralizer
ohǫna̲ˀdówanęh	'big potato'	[o-hǫna̲ˀd-ówan-ęh]	it.o-potato-big-stative
ga̲ˀdrehdowá:nęˀs	'big cars'	[ga̲-ˀdrehd-owá:n-ę-ˀs]	it.a-car-big-stative-pluralizer
ga̲ˀdrehdowá:nęh	'big car'	[ga̲-ˀdrehd-owá:n-ęh]	it.a-car-big-stative
ęgahnegowanę́ˀse:k	‘there will be big bodies of water’	[ę-ga-hneg-owanę́-ˀs-e:k]	future-it.a-water-big-pluralizer-ø.punctual.modalizer
ní:waˀs	'sizes’, 'how big they are'	[shęh] that [ní:-w-aˀs]	partitive-it.a-size.stative-pluralizer
ní:waˀ	'it is of a certain size, age'	[ní:-w-aˀ]	partitive-it.a-size.stative
nigaęnóˀdęˀs	‘blues music'	[oˀnigǫ̲hsadǫ̲hkgéha:ˀ] sad.kind [ni-ga-ęn-óˀdę-ˀs]	partitive-it.o-song-type.of.stative-pluralizer
nigaęnóˀdę:	'a type of song'	[ni-ga-ęn-óˀdę:]	partitive-it.a-song-type.of.stative
ní:yoht	'how, in what manner'	[shęh] that [ní:-yo-ht]	partitive-it.o-resemble.stative
nigehsinú:sˀuh	'I have two small legs'	[ni-g-e-hsin-ú:-s-ˀuh]	partitive-I.a-joinerE-leg-small-plural-diminutive
nigehsinú:ˀuh	'I have a small leg'	[ni-g-e-hsin-u:-ˀuh]	partitive-I.a-joinerE-leg-small-diminutive
ageˀdre̲hdáędǫˀ	'I have several cars'	[ag-e-ˀdre̲hd-á-ęd-ǫˀ]	I.o-joinerE-car-joinerA-lie.stative-distributive-stative
ageˀdre̲hdáęˀ	'I have a car'	[ag-e-ˀdre̲hd-á-ęˀ]	I.o-joinerE-car-joinerA-lie.stative
aknǫhsó:dǫˀ	'I have several houses'	[ak-nǫhs-ó:d-ǫˀ]	I.o-house-stand.stative-distributive-stative
aknǫ́hso:t	'I have a house'	[ak-nǫ́hs-o:t]	I.o-house-stand.stative
Gani:yǫ́:dǫˀ	'name of the white dog who went to heaven'	[ga-ni:yǫ́:d-ǫˀ]	it.a-hang.stative-distributive-stative
ganí:yǫ:t	'it is hanging'	[ga-ní:yǫ:t]	it.a-hang.stative
ohnawáodǫnyǫˀ	'springs'	[o-hnaw-á-od-ǫ-nyǫˀ]	it.o-rapids-joinerA-stand.stative-distributive-distributive-stative
ohnáwaot	'well, spring'	[o-hnáw-a-ot]	it.o-rapids-joinerA-stand.stative
dwakdǫ́:nyǫ:	'let's examine'	[dwa-kdǫ́:-nyǫ-:-ø]	we.all-look.at-distributive-modalizer-no.aspect
dwakdǫ:	'let us look’	[dwa-kdǫ:-ø]	we.all-look.at-no.aspect
ga̲háˀdǫ̲hnǫˀ	'a clothesline (several objects drying)’	[ga̲-háˀd-ǫ̲-hnǫˀ]	it.a-dry-stative-distributive-stative
hoyę́twa̲hsǫˀ	'he planted several things, a variety of things'	[ho-yę́tw-a̲-hsǫ-ˀ]	he.o-plant-joinerA-distributive-stative
hoyę́:twęh	'he has planted'	[ho-yę́:tw-ęh]	he.o-plant-stative
shǫgwaęnáwi̲hsǫˀ	'he has given us songs'	[shǫgwa-ęn-áwi̲-h-sǫˀ]	he:us-song-give-distributive-stative
shǫgwaęná:wih	'he has given all of us songs'	[agwe:gǫ́h] all [shǫgwa-ęn-á:wi-h]	he:us-song-give-stative
ędwana̲ˀdá:ksǫ:ˀ	'we will have a snack'	[ę-dwa-na̲ˀdá:-k-sǫ-:-ˀ]	future-we.all.inclusive.a-bread-eat-distributive-modalizer-punctual
deswatnętsáˀdrǫˀ	'you all have your arms crossed'	[de-sw-at-nęts-á-ˀ-drǫˀ]	dualic-you(all).o-semireflexive-arm-joinerA-noun.stem.former-distributive.stative
degaǫdę́hnǫdrǫˀ	'they are sisters'	[de-gaǫ-dę́-hnǫd-rǫˀ]	dualic-they(fe/males).a-semireflexive-follow-distributive.stative
degadęhnǫ́:de:ˀ	'my brother or sister'	[de-g-adę-hnǫ́:d-e-:-ˀ]	dualic-I.a-semireflexive-follow-go-purposive-stative
de̲hęnadę́hnǫdrǫˀ	'they are brothers'	[de̲-hęn-adę́-hnǫd-rǫˀ]	dualic-they(males).a-semireflexive-follow-distributive.stative
ęgrihwané:ˀa:k	'I will sin'	[ę-g-rihw-a-né:ˀa:k-ø]	future-I.a-matter-joinerA-sin-ø.punctual
desahjiyóhsrǫ:	'you really scratch!'	[de-s-ahj-iyó-hsrǫ-:-ø]	dualic-you(one).a-hand-good-distributive-modalizer-no.aspect
desahjí:yo:	'you scratch!'	[de-s-ahj-í:yo:]	dualic-you(one).a-hand-good.stative
otgiˀ	‘it is dirty’	[o-tgi-ˀ]	it.o-dirty-stative
ęhsé:tgiht	‘you will dirty it up’, ‘you will cause it to be dirty’	[ę-hs-e-tgi-hd-ø]	future-you(one).a-joinerE-dirty-cause-ø.punctual
gadenya̲ˀgwáhthaˀ	'I make or cause myself to vomit’; ‘I ambulemic'	[g-ad-e-nya̲ˀgw-á-ht-haˀ]	I.a-semireflexive-joinerE-vomit-joinerA-causative-habitual
agénya̲ˀgwahs	'I ama vomiter, I vomit all the time'	[ag-é-nya̲ˀgw-a-hs]	I.o-joinerE-vomit-joinerA-habitual
aˀóhdaˀ	'it got full'	[aˀ-ó-hd-aˀ]	factual-it.o-fill.up-punctual
ǫknéhagoˀ	'I was amazed'	[ǫk-néhago-ˀ]	factual.I.o-amazed-punctual
hahsgá:ne:s	'he has longings for'	[ha-hsgá:ne:-s]	he.a-long.for-habitual
hodrihwatgíhdǫh	'he is talking dirty’, ‘he is making dirty words'	[ho-d-rihw-a-tgí-hd-ǫh]	he.o-semireflexive-matter-joinerA-ugly-causative-stative
oíhwatgiˀ	'dirty language'	[o-íhw-a-tgi-ˀ]	it.o-matter-joinerA-ugly-stative
haˀwá:tsˀa:ˀ	'it went down to nothing'	[h-aˀ-w-á:tsˀ-a-:ˀ]	translocative-factual-it.a-use.up-joinerA-punctual
ęknǫ́ˀge̲haˀ	'I will drink milk'	[ę-k-nǫ́ˀg-e̲h-aˀ]	future-I.a-milk-drink-punctual
shegę́hęnih	'you abuse people’, ‘you are mean to someone'	[she-gę́hę-ni-h]	you:her-mean-benefactive-habitual
ęhsáhdo:k	'you will grow'	[ę-hs-áhdo:k-ø]	future-you(one).a-mature-ø.punctual
sagáeyǫˀ	'they returned'	[s-a-gáe-yǫ-ˀ]	repetitive-factual-they(fe/males).a-arrive-punctual
ohéhdatę:	'dry dirt'	[o-héhd-a-t-ę:]	it.o-earth-joinerA-dry-stative
agatsęnǫ́:ni:	'I amhappy'	[ag-atsęnǫ́:ni-:]	I.o-happy-stative
degaihwágenhęh	'there is an argument'	[de-ga-ihw-á-genh-ęh]	dualic-it.a-matter-joinerA-argue-stative
ohwę́jadeˀ	'existing earth'	[o-hwęj-a-deˀ]	it.o-earth-joinerA-exist.stative
age:kǫ́:niˀ	'I cooked a meal'	[a-g-e:-k-ǫ́:ni-ˀ]	factual-I.a-joinerE-food-make-punctual
ahékǫnyęˀ	'I cooked a meal for him'	[a-hé-k-ǫny-ę-ˀ]	factual-i:him-food-make-benefactive-punctual
ęhsadadrohé:gęˀ	‘you will accumulate (things, ideas, etc.) for yourself’	[ę-hs-adad-rohé:g-ę-ˀ]	future-you(one).a-reflexive-gather-benefactive-punctual
ęhsróhe:k	‘you will gather’	[ę-hs-róhe:k-ø]	future-you(one).a-gather-ø.punctual
gǫ̲hyádǫ̲hahs	'let me write for you'	[gǫ̲-hyádǫ̲-h-a-hs-ø]	i:you-write-pronunciation.h-joinerA-benefactive-ø.aspect
kyá:dǫ:	'let me write'	[k-hyá:dǫ:-ø]	I.a-write-ø.aspect
hoyę́:twęh	'he has planted'	[ho-yę́:tw-ęh]	he.o-plant-stative
haˀhohahóˀktahs	'the road ran out for him'	[h-aˀ-ho-hah-óˀkd-a-hs-ø]	translocative-factual-he.o-road-end-joinerA-benefactive-ø.punctual
ęhsadadrá:gwahs	'you will choose for yourself'	[ę-hs-adad-rá:gw-a-hs-ø]	future-you(one).a-reflexive-choose-joinerA-benefactive-ø.punctual
ęhsrá:goˀ	'you will choose or take out'	[ę-hs-rá:go-ˀ]	future-you(one).a-choose-punctual
deshagodihwagé:nhahs	'they argue for us'	[de-shagodi-ihw-a-gé:nh-a-hs]	dualic-they:us-matter-joinerA-argue.for-joinerA-benefactive.habitual
a:hyayaˀdagénhaˀ	'he would help you'	[a:-hya-yaˀd-a-génh-aˀ]	indef-he:you-body-joinerA-argue.for-punctual
hǫwayętwę́:nih	'he plants for him'	[hǫwa-yętw-ę́:-ni-h]	he:him-plant-joinerA-benefactive-habitual{Foster,
hoyę́:twęh	'he planted'	[ho-yę́:tw-ęh]	he.o-plant-stative
agegę̲hę́ˀdanih	'I am annoyed, sick of it'	[ag-e-gę̲hę́ˀd-a-ni-h]	I.o-joinerE-sick.of-joinerA-benefactive-habitual
ahsgegę̲hę́ˀdęˀ	'you got sick of me; you are bored with me'	[a-hsg-e-gę̲hę́ˀd-ę-ˀ]	factual-you:me-sick.of-benefactive-punctual
ahékǫnyęˀ	‘I cooked a meal for him’	[a-hé-k-ǫny-ę-ˀ]	factual-i:him-food-make-benefactive-punctual
age:kǫ́:niˀ	‘I cooked a meal’	[a-g-e:-k-ǫ́:ni-ˀ]	factual-I.a-joinerE-food-make-punctual{Foster,
ashagonǫhsǫnyęˀ	‘he built her a house’	[a-shago-nǫhs-ǫny-ę-ˀ]	factual-he:her-house-make-benefactive-punctual
ahehswa̲ˀné:dęˀ	‘I supported him’	[a-he-hswa̲ˀn-é:d-ę-ˀ]	factual-i:him-upper.back-stand-benefactive-punctual
hehswáˀne:t	‘I support or back him’	[he-hswáˀn-e:t]	i:him-upper.back-stand.stative
ahadadrihwagwé:nyęˀ	‘he had earned it for himself’	[a-ha-dad-rihw-a-gwé:ny-ę-ˀ]	factual-he.a-reflexive-matter-joinerA-succeed-benefactive-punctual
ahsadadrihwagwé:nyaˀs	‘you are a success’	[a-hs-adad-rihw-a-gwé:ny-aˀs-ø]	factual-you(one).a-reflexive-matter-joinerA-succeed-benefactive-ø.punctual
ęhshewayę́:sdęˀ	‘you will train, educate, teach someone’	[ę-hshe-wayę́:sd-ę-ˀ]	future-you:her-learn-benefactive-punctual
ęhsadewá:yę:s	‘you will learn’	[ę-hs-ad-e-wá:yę:sd-ø]	future-you(one).a-semireflexive-joinerE-learn-ø.punctual
ęhsgǫganyáˀgęˀ	‘I will repay you for your actions’	[ę-hs-gǫ-ganyáˀg-ę-ˀ]	future-repetitive-I:you-pay-benefactive-punctual
ęhséganyaˀk	‘you will pay’	[ę-hs-é-ganyaˀk-ø]	future-you(one).a-joinerE-pay-ø.punctual
ǫdadri̲hǫ́nyanih	'she is reading'	[ǫ-dad-ri̲h-ǫ́ny-a-ni-h]	she.a-reflexive-matter-make-joinerA-benefactive-habitual
ęhsadadríhǫnyęˀ	'you will read'	[ę-hs-adad-ríh-ǫny-ę-ˀ]	future-you(one).a-reflexive-matter-make-benefactive-punctual
wadadri̲hǫ́nyani:	'reading material'	[w-adad-ri̲h-ǫ́ny-a-ni-:]	it.a-reflexive-matter-make-joinerA-benefactive-stative
sadadri̲hǫ́:nyęh	'read!'	[s-adad-ri̲h-ǫ́:ny-ę-h]	you(one).a-reflexive-matter-make-benefactive-pronunciation.h
owáno̲hsdǫh	'it (weather) got cold'	[o-wá-no̲-hsd-ǫh]	it.o-air-cold-cause-stative
owá:no:ˀ	'it (weather) is cold'	[o-wá:-no-:ˀ]	it.o-air-cold-stative
sagána̲ˀnohs	'it (an object) became cold'	[s-a-gá-na̲ˀ-no-hsd-ø]	repetitive-factual-it.a-object-cold-causative-ø.punctual
onáˀno:ˀ	'it (an object) is cold, cool'	[o-náˀ-no-:ˀ]	it.o-object-cold-stative
sawęhni̲srí:yohs	'it became a nice day again'	[s-a-w-ęhni̲sr-í:yo-hs-ø]	repetitive-factual-it.a-day-good-cause-ø.punctual
wę̲hnihsrí:yo:	'it is a nice day'	[w-ę̲hnihsr-í:yo:]	it.a-day-good.stative
ganáˀno̲hsthaˀ	‘refrigerator’ or ‘it causes food to get cold’	[gakwáˀ] food [ga-náˀ-no̲-hst-haˀ]	it.a-object-cold-cause-habitual
agówanheˀ	'it became big'	[a-g-ówan-heˀ-ø ]	factual-it.a-big-inchoative-ø.punctual
gowá:nęh	'it is big'	[g-owá:n-ęh]	it.a-big-stative
ęwaˀdáihaˀt	'it will get hot'	[ę-wa-ˀdáih-a-ˀt-ø]	future-it.a-hot-joinerA-inchoative-ø.punctual
oˀdáihę:	'it is hot'	[o-ˀdáih-ę:]	it.o-hot-stative
wa̲ˀdaiháˀthaˀ	'it heats things up'	[wa-ˀdaih-á-ˀt-haˀ]	it.a-hot-joinerA-inchoative-habitual
ętsaˀdáihaˀt	'you will heat it up; you will make it hot'	[ę-t-sa-ˀdáih-a-ˀt-ø]	future-cislocative-you(one).o-hot-joinerA-inchoative-ø.punctual
oˀdaiháˀdǫh	'it (weather) is really hot'	[o-ˀdaih-á-ˀd-ǫh]	it.o-hot-joinerA-inchoative-stative
sędáˀdrah	'you go to bed, you go to sleep!'	[s-ęd-á-ˀdr-a-h]	you(one).o-sleep-joinerA-dislocative-joinerA-pronunciation.h
sę́:daˀ	'you sleep!'	[s-ę́:daˀ]	you(one).o-sleep-ø.aspect
ęyǫdawę́ˀnaˀ	'she will go swimming'	[ę-yǫ-d-awę́-ˀn-a-ˀ]	future-she.a-semireflexive-swim-dislocative-joinerA-punctual
ęyǫ́dawę:ˀ	'she will swim'	[ę-yǫ́-d-awę-:ˀ]	future-she.a-semireflexive-swim-punctual
ahęnadáhnyo̲hnaˀ	'they went fishing'	[a-hęn-ad-áhny-o̲-hn-a-ˀ]	factual-they(males).a-semireflexive-hook-submerge-dislocative-joinerA-punctual
ahęnadáhnyo:ˀ	'they (males) fished'	[a-hęn-ad-áhny-o-:ˀ]	factual-they(males).a-semireflexive-hook-submerge-punctual
ęgé:kdǫ:ˀ	'I will see, look'	[ę-g-é:-kdǫ-:ˀ]	future-I.a-joinerE-examine-punctual
dwakdǫ́hnah	'let us go look'	[dwa-kdǫ́-hn-a-h]	we.all-examine-dislocative-joinerA-pronunciation.h
dwakdǫ:	'let us look'	[dwa-kdǫ:]	we.all-examine-ø.aspect
a:gatrǫ́nya̲hnaˀ	'I should go and tell'	[a:-g-at-hrǫ́ny-a̲-hn-a-ˀ]	indefinite-I.a-semireflexive-tell-joinerA-dislocative-joinerA-punctual
a:gatrǫ́:niˀ	'I should tell'	[a:-g-at-hrǫ́:ni-ˀ]	indefinite-I.a-semireflexive-tell-punctual
ęhsahǫgáhaˀ	'you'll be invited or asked to go'	[ę-hs-ahǫg-á-h-a-ˀ]	future-you(one).a-understand-joinerA-dislocative-joinerA-punctual
ęhsáhǫ:k	'you will understand a language'	[ę-hs-áhǫ:k-ø]	future-you(one).a-understand-ø.punctual
si̲hsá:khah	'go and look for it!'	[s-i̲hsá:k-h-a-h]	you(one).a-seek-dislocative-joinerA-pronunciation.h
si̲hsa:k	'look for it!'	[s-i̲hsa:k-ø]	you(one).a-seek-ø.aspect
ęhayętwáhsaˀ	'he will go planting'	[ę-ha-yętw-á-hs-a-ˀ]	future-he.a-plant-joinerA-dislocative-joinerA-punctual
ęháyętoˀ	'he will plant'	[ę-há-yęto-ˀ]	future-he.a-plant-punctual
ęsyęˀgǫtwáhsaˀ	'you will go burn tobacco'	[ę-s-yęˀg-ǫtw-á-hs-a-ˀ]	future-you(one).a-tobacco-burn.up-joinerA-dislocative-joinerA-punctual
ęyǫdawę́ˀnaˀ	'she will go swimming'	[ę-yǫ-d-awę́-ˀn-a-ˀ]	future-she.a-semireflexive-swim-dislocative-joinerA-punctual
ęyǫ́dawę:ˀ	'she will swim'	[ę-yǫ́-d-awę-:ˀ]	future-she.a-semireflexive-swim-modalizer-punctual
sędáˀdrah	'you go to bed', 'you go to sleep'	[s-ęd-á-ˀdr-a-h]	you(one).o-sleep-joinerA-dislocative-joinerA-pronunciation.h/no.aspect
sę́:daˀ	'you sleep'	[s-ę́:daˀ]	you(one).o-sleep-ø.aspect
agatrǫnyáhnǫh	'I am telling now'	[ag-at-hrǫny-á-hn-ǫh]	I.o-semireflexive-tell-joinerA-dislocative-stative
agáhyakhsǫ:	'I amgoing and eating fruit'	[ag-áhy-a-k-hs-ǫ:]	I.o-fruit-joinerA-eat-dislocative-stative
gowiyaę́da̲ˀdreˀ	'she is with child'	[go-wiy-a-ę́d-a̲-ˀdr-e-ˀ]	she.o-offspring-joinerA-have-joinerA-dislocative-go-punctual
agwíyaęˀ	'I have a child'	[ag-wíy-a-ęˀ]	she.o-offspring-joinerA-lie.stative
dęgaihwaędáˀdreˀ	'harmony', 'every idea will always come together'	[d-ę-ga-ihw-a-ęd-á-ˀdr-e-ˀ]	dualic-future-it.a-matter-joinerA-lie-joinerA-dislocative-go-punctual
dęgaihwáędaˀ	'it will come to an agreement, a consensus'	[d-ę-ga-ihw-á-ęd-a-ˀ]	dualic-future-it.a-matter-joinerA-lie-joinerA-punctual
ęgadręnóda̲ˀnaˀ	'I will go sing'	[ę-g-ad-ręn-ód-a̲-ˀn-a-ˀ]	future-I.a-semireflexive-song-stand-joinerA-dislocative-joinerA-punctual
ęgadręnó:dęˀ	'I will sing'	[ę-g-ad-ręn-ó:d-ęˀ]	future-I.a-semireflexive-song-stand-punctual
ęgade̲ˀsgǫ́daˀnaˀ	'I will go fry it'	[ę-g-ad-e̲-ˀsg-ǫ́d-a-ˀn-a-ˀ]	future-I.a-semireflexive-joinerE-roast-attached-joinerA-dislocative-joinerA-punctual
ęgade̲ˀsgǫ́:dęˀ	'I will fry, roast it'	[ę-g-ad-e̲-ˀsg-ǫ́:d-ęˀ]	future-I.a-semireflexive-joinerE-roast-attached-punctual
gayę́twagyeˀ	'it is planted along'	[ga-yę́tw-a-gy-e-ˀ]	it.a-plant-joinerA-progressive-go-stative
gayę́:twęh	'it is planted'	[ga-yę́:tw-ęh]	it.a-plant-stative
hǫwahnǫdrá:gyeˀ	'someone is following him along'	[hǫwa-hnǫdr-á:-gy-e-]	s/he:him-follow-joinerA-progressive-go-stative
hǫwáhnǫdreˀ	'someone is following him'	[hǫwá-hnǫdr-e-ˀ]	s/he:him-follow-go-stative
haˀdehodinęhę́dagyeˀ	'they (m) are guarding as they are on their way over, in transit'	[haˀ-de-hodi-nęhę́d-a-gy-e-ˀ]	translocative-dualic-they(males).o-guard-joinerA-progressive-go-stative
todinę̲hę́:deˀ	'they are standing there' (in a line formation)', 'they are guarding'	[t-hodi-nę̲hę́:d-e-ˀ]	cislocative-they(males).o-guard-go-stative
ohsáwagyeˀ	'it is beginning'	[o-hsáw-a-gy-e-ˀ]	it.o-begin-joinerA-progressive-go-stative
ętsáhsawęˀ	'you will begin'	[ę-t-s-áhsaw-ęˀ]	future-cislocative-you(one).a-begin-punctual
otsihsˀǫ̲hǫ́:gyeˀ	'it is getting mature'	[o-t-hs-ihsˀ-ǫ̲h-ǫ́:-gy-e-ˀ]	it.o-semireflexive-noun-finish-stative-joinerA-progressive-go-stative
otsíhsˀǫh	'it is done for the season', 'it has gone full cycle', 'it is mature', 'they (plants) have finished out'	[o-t-hs-íhsˀ-ǫh]	it.o-semireflexive-noun-finish-stative
hayę́twagwahs	'he is harvesting'	[ha-yę́tw-a-gw-a-hs]	he.a-plant-joinerA-reversive-joinerA-habitual
hayę́:twahs	'he is planting'	[ha-yę́:tw-a-hs]	he.a-plant-joinerA-habitual
ahayętwá:goˀ	'he did harvest'	[a-ha-yętw-á:-go-ˀ]	factual-he.a-plant-joinerA-reversive-punctual
aháyętoˀ	'he did plant'	[a-há-yęto-ˀ]	factual-he.a-plant-punctual
hoyę́twagwęh	'he harvested it'	[ho-yę́tw-a-gw-ęh]	he.o-plant-joinerA-reversive-stative
hoyę́:twęh	'he planted it'	[ho-yę́:tw-ęh]	he.o-plant-stative
sasatrǫnyáhsih	'get undressed again'	[sa-s-at-hrǫny-á-hsi-h]	repetitive-you(one).a-semireflexive-dress-joinerA-reversive-pronunciation.h
sasa:trǫ́:nih	'get dressed again'	[sa-s-a:t-hrǫ́:ni-h]	repetitive-you(one).a-semireflexive-dress-pronunciation.h
it,	'my having seen it'	[ag-é:-gę-:]	I.o-joinerE-see-stative
aˀé:yǫˀ	‘she arrived’	[aˀ-é:-yǫ-ˀ]	factual-she.a-arrive-punctual
ęga:dé:gaˀt	‘I will start a fire’	[ę-g-a:dé:g-a-ˀt-ø]	future-I.a-burn-joinerA-causative-ø.punctual
ęhségawe:ˀ	‘you will row’	[ę-hs-é-gawe-:ˀ]	future-you(one).a-joinerE-paddle-punctual
sagawe̲há:gyeˀ	‘you are paddling along’	[sa-gawe̲-h-á:-gy-e-ˀ]	you(one).o-paddle-pronunciation.h-joinerA-progressive-go-stative
agadǫ̲hswéˀdanih	‘I am hungry’	[ag-ad-ǫ̲hswéˀd-a-ni-h]	I.o-semireflexive-hunger-joinerA-benefactive-habitual
ogé:draˀ	‘it is green, unripe’; ‘raw fruit’	[o-gé:draˀ]	it.o-unripe.stative
agǫ́:nihs	‘she makes it into something’; ‘she earns it’	[ag-ǫ́:ni-hs]	she.o-make-habitual
okahs	‘it leaks’	[o-ka-hs]	it.o-leak-habitual
swatgę́nihsˀahs	‘you have meetings all the time’	[sw-at-gę́nihsˀ-a-hs]	you(all).a-semireflexive-meet-joinerA-habitual
hehahé:haˀ	‘he places it there all the time’	[he-ha-hré:-haˀ]	translocative-he.a-place-habitual
deknége̲haˀ	‘I do not drink any more’	[de-k-hnége̲-haˀ]	dualic-I.a-drink-habitual
gadáhnyoˀs	‘I fish continually’	[g-ad-áhny-o-ˀs]	I.a-semireflexive-hook-submerge-habitual
ehyádǫ̲haˀ	‘she is a writer or secretary’	[e-hyádǫ̲-haˀ]	she.a-write-habitual
shagóhse̲hthaˀ	‘he is a robber, stealer’	[shagó-hse̲ht-haˀ]	he:them-hide-habitual
hatgéhǫhaˀ	‘he is an auctioneer, a seller’	[h-at-géhǫ-haˀ]	he.a-semireflexive-sell-habitual
gagrahs	‘it stinks’, ‘it is strong-smelling’	[ga-gra-hs]	it.a-stink-habitual
agáhdrǫhs	‘I amfrightened of it'	[ag-áhdrǫ-hs]	I.o-frighten-habitual
kehswáhęhs	‘I hate her'	[ke-hswáhę-hs]	i:her-hate-habitual
gadejiˀóhgyaˀs	‘I am cutting my nails'	[g-ade-jiˀóh-gyak-ˀs]	I.a-semireflexive-nail-cut-habitual
ehé:yǫhs	‘she is dying, on her deathbed'	[e-hé:yǫ-hs]	she.a-die-habitual
segé:tsgwahs	‘you are lifting it to a vertical position’; ‘you give parties'	[s-e-gé:tsgw-a-hs]	you(one).a-joinerE-raise.to.vertical-joinerA-habitual
gragé:wahs	‘I am erasing or wiping it'	[g-ragé:w-a-hs]	I.a-wipe-joinerA-habitual
satgáhǫhaˀ	‘you are paying attention, watching right now'	[s-at-gáhǫ-haˀ]	you(one).a-semireflexive-watch-habitual
tgyahsǫ́haˀ	‘I call them’; ‘I am a bingo caller'	[t-g-yahsǫ́-haˀ]	cislocative-I.a-call-habitual
ga̲ˀníkǫ̲haˀ	‘sewing machine’	[ga̲-ˀníkǫ̲-haˀ]	it.a-sew-habitual
eˀní:kǫhs	‘seamstress’	[e-ˀní:kǫ-hs]	she.a-sew-habitual
Ǫdada̲hnyóhaˀ	‘Fishing Dance’	[ǫdada̲-hnyó-haˀ]	they:them-fish-habitual
gadáhnyoˀs	‘I fish continually’	[g-ad-áhnyo-ˀs]	I.a-semireflexive-fish-habitual
hadáhnyoˀ	‘he is a fisherman’	[ha-d-áhnyo-ˀ]	he.a-semireflexive-fish-habitual
hęnáda̲hnyoh	‘they are fishing’	[hęn-ád-a̲hnyo-h]	they(males)-semireflexive-fish-habitual
gotowinyǫ́ˀse:	‘she has a cold’	[go-t-howinyǫ́ˀse:]	she.o-have.a.cold.stative
de̲howę:sǫ:	‘he has shoes on’	[de̲-ho-wę́:sǫ:]	dualic-he.o-be.shod.stative
ó:gęt	‘it is visible'	[ó:-gęt]	it.o-visible.stative
niyohá:kˀah	‘it is short'	[ni-yo-há:kˀah]	partitive-it.o-short.stative
ohóˀdę:ˀ	‘it is soft'	[o-hóˀdę:ˀ]	it.o-soft.stative
ohní:yǫh	‘it is hard'	[o-hní:y-ǫh]	it.o-hard-stative
agatganǫ́:ni:	‘I amwealthy'	[ag-at-ganǫ́:ni-:]	I.o-semireflexive-wealthy-stative
agatsenǫ́:ni:	‘I amhappy'	[ag-at-hsenǫ́:ni-:]	I.o-semireflexive-happy-stative
gadręnagáˀǫh	‘it is sweet-smelling (food odours)'	[ga-dręn-a-gáˀ-ǫh]	it.a-smell-joinerA-sweet-stative
gadręnahshá:sdeˀ	‘it is strong-smelling'	[ga-dręn-a-hshá:sdeˀ]	it.a-smell-joinerA-strong.stative
ga̲hǫ́ˀji:	‘it is dark'	[ga̲-hǫ́ˀji:]	it.a-dark.stative
knę́:ye:s	‘I amtall'	[k-hnę́:y-e:s]	I.a-stature-long.stative
niknę́:yaˀ	‘I amshort'	[ni-k-hnę́:y-aˀ]	partitive-I.a-stature-short.stative
syadǫ̲hsráędiˀ	‘you are smart (educated)'	[s-yadǫ̲hsrá-ędiˀ]	you(one).a-paper-know.stative
otgiˀ	‘it is dirty’	[o-tgi-ˀ]	it.o-dirty-stative
ohstéhsdǫh	‘it has evaporated'	[o-hstéhsd-ǫh]	it.o-dry.up-stative
owa:nóhsdǫh	‘it got cold (weather)'	[o-wa:-nóhsd-ǫh]	it.o-air-get.cold-stative
hehó:gyǫ:	‘he has thrown it'	[he-hó:-gy-ǫ:]	translocative-he.o-semireflexive-throw-stative
de̲hóyętwęh	‘he did not plant'	[de̲-hó-yętw-ęh]	dualic-he.o-plant-stative
agekwędáˀǫh	‘I have finished eating'	[ag-e-kw-ędáˀ-ǫh]	I.o-joinerE-food-finish-stative
hewagadę́nye̲hdǫh	‘I sent it'	[he-wag-adę́-nye̲hd-ǫh]	translocative-I.o-semireflexive-send-stative
agatǫdę́ˀǫh	‘I’ve heard it before'	[ag-at-hǫdę́ˀ-ǫh]	I.o-semireflexive-hear-stative
wadeˀnyędę́hsdǫh	'the act of measuring'	[wa-d-e-ˀnyędę́hsd-ǫh]	it.a-semireflexive-joinerE-cause.to.measure-stative
watwihsdǫnyáˀdǫh	'profit, investment'	[wa-t-hwihsd-ǫnyáˀd-ǫh]	it.a-semireflexive-money-cause.to.make-stative
wa̲hyá:gwęh	‘picked fruit’	[wa̲-hy-á:-gw-ęh]	it.a-fruit-joinerA-pick-stative
swagahshaˀdrǫ́:nyǫh	‘I amrecalling, remembering'	[s-wag-ahshaˀdr-ǫ́:-ny-ǫh]	repetitive-I.o-remember-joinerA-pluralizer-stative
odáˀgra̲hdǫh	‘it is floating'	[o-d-áˀgra̲hd-ǫh]	it.o-semireflexive-float-stative
dęya:wę́:dǫh	‘it sways'	[d-ę-ya:w-ę́:d-ǫh]	dualic-future-it.o-sway-stative
sadędonyáˀdǫh	‘you are joking, making fun of something'	[s-adę-donyáˀd-ǫh]	you(one).o-semireflexive-make.fun.of-stative
deyagotgrę́grę̲hdǫh	‘she is frowning'	[de-yago-t-grę́grę̲hd-ǫh]	dualic-she.o-semireflexive-wrinkle.up-stative
agenya̲ˀgwáhǫh	‘I am vomiting (right now)'	[ag-e-nya̲ˀgw-á-h-ǫh]	I.o-joinerE-vomit-joinerA-dislocative-stative
sęnǫ́hdǫnyǫh	‘you are wondering, thinking'	[s-ęnǫ́hdǫny-ǫh]	you(one).o-wonder-stative
gyagogyęhę́:twęh	‘she is pulling it'	[g-yago-g-yęhę́:tw-ęh]	cislocative-she.o-semireflexive-pull-stative
desaˀnigǫhaˀdó:gęh	‘you cannot decide which way to go, you are flighty'	[de-sa-ˀnigǫh-a-dó:g-ęh]	negative-you(one).o-mind-joinerA-true-stative
agídaˀǫh	‘I was asleep’; ‘I amsleeping'	[ag-ídaˀ-ǫh]	I.o-sleep-stative
saihwa̲ˀné:gęh	‘you are praying’; ‘you have prayed'	[sa-rihw-a̲-ˀné:g-ęh]	you(one).o-matter-joinerA-pray-stative
desęna̲ˀsgwáhgwęh	‘you have jumped’; ‘you are jumping?'	[de-s-ę-na̲ˀsgw-á-hgw-ęh]	dualic-you(one).o-semireflexive-bouncy.surface-joinerA-lift-stative
hodáˀǫh	'yesterday he did sleep’; 	[te:dę́:ˀ] ‘yesterday’ [ho-dáˀ-ǫh]	he.o-sleep-stative;
hodáˀǫh	'he is sleeping right now’;	[o:nę́h] ‘now’ [ho-dáˀ-ǫh]	he.o-sleep-stative;
wa̲hyá:gwęh	'picked fruit'	[w-a̲hy-á:-gw-ęh]	it.a-fruit-joinerE-pick-stative
wadę́nhaˀǫh	'it is chartered, hired'	[w-adę́-nhaˀ-ǫh]	it.a-semireflexive-hire-stative
wagyǫ:	'something thrown away; discards'	[w-agyǫ-:]	it.a-throw-stative
degágwatwęh	'a hem'	[de-gá-gwatw-ęh]	dualic-it.a-hem-stative
gáohǫ:ˀ	'the act of gathering'	[gá-oh-ǫ-:-ˀ]	it.a-gather-stative-nominalizer-nsf
gayaˀdowéhdǫ:ˀ	'the idea of thinking'	[ga-yaˀdowéhd-ǫ-:-ˀ]	it.a-think.about-stative-nominalizer-nsf
atǫ:dę́ˀǫ:ˀ	'the act of hearing'	[at-hǫ:dę́-ǫ-:-ˀ]	ø.prefix-semireflexive-hear-stative-nominalizer-nsf
adówadǫ:ˀ	'the hunt'	[ad-ówad-ǫ-:-ˀ]	ø.prefix-semireflexive-hunt-stative-nominalizer-nsf
onǫhsodáiyǫ:ˀ	'sickness, illness'	[o-nǫhsod-á-iy-ǫ-:-ˀ]	it.o-sickness-verb-stative-nominalizer-nsf
ǫgyaˀditgę́hsǫ:ˀ	'nightmares'	[ǫ-g-yaˀd-itgę́-hs-ǫ-:-ˀ]	someone-semireflexive-body-rise-pluralizer-stative-nominalizer-nsf
aˀéganyaˀk	‘she paid’	[aˀ-e-ganyaˀg-ø]	factual-she.a-pay-ø.punctual
gagánya̲ˀgǫh	‘payment’	[ga-ga-nya̲ˀg-ǫh]	it.a-price-pay-stative
hękrih	‘I will pour’	[h-ę-k-hrih-ø]	translocative-future-I.a-pour-ø-punctual
gahíhǫh	‘it is spilled’	[ga-hríh-ǫh]	it.a-spill-stative
há:ge:	‘Just maybe I should go there. ’	[toh] there [giˀ] just [shęh] that [h-á:-g-e:]	there-indefinite-I.a-go-no.aspect
gęh.	‘Tell me if/whether you are coming with us.’	[daskro:wíh] you.tell.me  [ę-dw-e:]	future-we.all-go-no.aspect
ę́:dwe:ˀ	‘we will go together’	[ę́:-dw-e:-ˀ]	future-we.all.inclusive.a-go-punctual
a:yáihe:	‘She did not care that she was going to her death.’	[tęˀ] not [dejǫhsdí:s] she.did not.pay.attention [o:nę́h] now [gyę:gwáˀ] if [a:-ya-ihe:]	indefinite-she.a-die-no.aspect
ęgíhe:ˀ	‘I will die’	[ę-g-ihe:-ˀ]	future-I.a-die-punctual
hadowahsgę́hę:ˀ	'he used to be a hunter'	[ha-d-owad-hs-gę́hę:ˀ]	he.a-semireflexive-hunt-past
hadó:wa:s	'he is a hunter'	[ha-d-ó:wa:d-s]	he.a-semireflexive-hunt-habitual
hahdóhsgę̲hę:ˀ	'he used to dive'	[ha-hdó-hs-gę̲hę:ˀ]	he.a-dive-past
hahdo:s	'he dives’, ‘he is a diver'	[ha-hdo:-s]	he.a-dive-habitual
sahtgaˀwa̲hsgę́hę:ˀ	'you used to let go, you used to give up'	[s-ahtgaˀw-a̲-hs-gę́hę:ˀ]	you(one).a-release-joinerA-past
sahtgaˀs	'you forfeit, you let go of things all the time'	[s-ahtgaˀ-s]	you(one).a-release-habitual
sadǫhwidáˀthahk	'you used to swing (long ago)'	[s-ad-ǫhwidáˀt-ha-hk]	you(one).a-semireflexive-swing-habitual-former
sadǫhwidáˀtaˀ	'you swing (all the time); you are a swinger'	[s-ad-ǫhwidáˀt-haˀ]	you(one).a-semireflexive-swing-habitual
gohsóˀkhahk	'she used to limp'	[go-hsóˀk-ha-hk]	she.o-limp-habitual-former
go̲hsóˀkaˀ	'she is limping'	[go̲-hsóˀk-haˀ]	she.o-limp-habitual
hahsgyáǫhahk	'he used to walk quickly'	[ha-hsgyáǫ-ha-hk]	he.a-walk.quickly-habitual-former
hahsgyáǫhaˀ	'he walks quickly', 'he gives someone encouragement'	[ha-hsgyáǫ-haˀ]	he.a-walk.quickly-habitual
desahsǫhdré:hahk	'you used to join things together, put it together'	[de-s-ahsǫhdré:-ha-hk]	dualic-you(one).a-join-habitual-former
desahsǫdré:haˀ	'you join things together all the time’; ‘you do puzzles'	[de-s-ahsǫdré:-haˀ]	dualic-you(one).a-join-habitual
ǫdrę́nothahk	'she used to sing'	[ǫ-d-rę́n-ot-ha-hk]	she.a-semireflexive-song-stand-habitual-former
gaǫdręnó:taˀ	'they (f/m) are singers'	[gaǫ-d-ręn-ó:t-haˀ]	they(fe/males).a-semireflexive-song-stand-habitual
dędwadadrihwanǫ́hkwa:k	'we all will show respect for one another'	[d-ę-dw-adad-rihw-a-nǫ́hkw-ha-:k]	dualic-future-we.all.inclusive.a-reflexive-matter-joinerA-love-habitual-modalizer
ęwadę̲hníˀdoˀkta:k	'every month will end'	[ę-w-ad-ę̲hníˀd-oˀkt-ha-:k]	future-it.a-semireflexive-month-end-habitual-modalizer
hewádoˀktaˀ	'it ends over there'	[he-w-ád-oˀkt-haˀ]	translocative-it.a-semireflexive-end-habitual
ęhsáhsoˀka:k	'you will limp'	[ę-hs-áhsoˀk-ha-:k]	future-you(one).o-limp-habitual-modalizer
go̲hsóˀkaˀ	'she is limping'	[go̲-hsóˀk-haˀ]	she.o-limp-habitual
gǫnǫ́hkwaˀ	'I love you'	[gǫ-nǫ́hkw-haˀ]	i:you-love-habitual
ęhswagáęse:k	'you all will be willing'	[ę-hswa-gáę-s-e:k]	future-you(all).o-willing-habitual-modalizer
sagáęs	'you are willing'	[sa-gáę-s]	you(one).o-willing-habitual
tsǫ:	'just let him keep planting'	[a:-ha-yętw-a̲-hs-é:k]	indefinite-he.a-plant-joinerA-habitual-modalizer
hayę́:twahs	'he is a planter'	[ha-yę́:tw-a-hs]	he.a-plant-joinerA-habitual
dęhatganyáhse:k	'he will be desperate'	[d-ę-ha-t-gany-á-hs-e:k]	dualic-future-he.a-semireflexive-want.desperately-joinerA-habitual-modalizer
a:ga̲hyágwa̲hse:k	'I might be a fruit picker (not very definite)'	[a:-g-a̲hy-á-gw-a̲-hs-e:k]	indefinite-I.a-fruit-joinerA-pick-joinerA-habitual-modalizer
ga̲hyá:gwahs	'I am picking fruit'	[g-a̲hy-á:-gw-a-hs]	I.a-fruit-joinerA-pick-joinerA-habitual
agahyagwę́hne:ˀ	'I've done picking fruit'	[ag-ahy-a-gw-ę́-hne:ˀ]	I.o-fruit-joinerA-pick-stative-remote
agáhyagwęh	'I have picked fruit (farther in the past)’	[ag-áhy-a-gw-ęh]	I.o-fruit-joinerA-pick-stative
ga̲hyá:gwahs	'I ama fruit picker'	[g-a̲hy-á:-gw-a-hs]	I.o-fruit-joinerA-pick-joinerA-habitual
agekǫníhne:ˀ	'I have cooked'	[ag-e-k-ǫní-hne:ˀ]	I.o-joinerE-food-make.stative-remote
age:kǫ́:ni:	'I cooked'	[ag-e:-k-ǫ́:ni-:]	I.o-joinerE-food-make-stative
gekǫ́:nihs	'I ama cook'	[g-e-k-ǫ́:ni-hs]	I.a-joinerE-food-make-habitual
sajagǫ̲ˀǫ́hne:ˀ	'you singular have persevered'	[sa-jagǫ̲-ˀǫ́-hne:ˀ]	you(one).o-persevere-stative-remote
agejagǫ́ˀǫh	'I do persevere all the time'	[ag-e-jagǫ́-ˀǫh]	I.o-joinerE-persevere-stative
gejá:gǫhs	'I persevere all the time'	[g-e-já:gǫ-hs]	I.a-joinerE-persevere-habitual
sagahdrǫníhne:ˀ	'you used to stare all the time'	[sa-gahdr-ǫní-hne:ˀ]	you(one).o-eye-make.stative-remote
sagahdrǫ́:ni:	'you are 'nosy' with your eyes, always looking’	[sa-gahdr-ǫ́:ni-:]	you(one).p-eye-make-stative
sagahdrǫ́:nihs	'you are staring at it'	[sa-gahdr-ǫ́:ni-hs]	you(one).o-eye-make-habitual
dewagadǫhwęjóni̲hne:ˀ	'I wanted something in the past'	[de-wag-ad-ǫhwęjóni̲-hne:ˀ]	dualic-I.o-semireflexive-want.stative-remote
dewagadǫhwęjǫ́:nih	'I want something'	[de-wag-ad-ǫhwęjǫ́:ni-h]	dualic-I.o-semireflexive-want-stative
desadǫ̲hwęjǫníhsgǫ:	'you always want something'	[de-sa-d-ǫ̲hwęjǫní-hsgǫ:]	dualic-you(one).o-semireflexive-want-facilitative.habitual
eksaˀgowáhne:ˀ	'she used to be pretty'	[e-ksaˀ-gowá-hne:ˀ]	she.a-child-great.stative-remote
eksaˀgó:wah	'she is pretty'	[e-ksaˀ-gó:wah]	she.a-child-great.stative
saníˀǫhne:ˀ	'you used to be stingy of it'	[sa-ní-ˀǫ-hne:ˀ]	you(one).o-greedy-stative-remote
saníˀǫh	'you are stingy, greedy, cheap'	[sa-ní-ˀǫh]	you(one).o-greedy-stative
gonadręnó:daˀk	'they f/m did sing'	[gon-ad-ręn-ó:d-a-ˀ-k]	they(fe/males).o-semireflexive-song-stand-joinerA-causative-former
hodrę́:no:t	'he is singing'	[ho-d-rę́:n-o:t]	he.o-semireflexive-song-stand.stative
gaǫdręnó:thaˀ	'they f/m are singers'	[gaǫ-d-ręn-ó:t-haˀ]	they(fe/males).a-semireflexive-song-stand-habitual
gani:yǫ́:daˀk	'it hung there, it used to hang there'	[ga-ni:yǫ́:d-a-ˀ-k]	it.a-hang.stative-joinerA-causative-former
ganí:yǫ:t	'it is hanging'	[ga-ní:yǫ:t]	it.a-hang.stative
wa̲hyaniyǫ́:thaˀ	'different or variety of hanging fruits'	[w-a̲hy-a-niyǫ́:t-haˀ]	it.a-fruit-joinerA-hang-habitual
tgáenagrehk	'they females or mixed did live there, used to live there'	[t-gáe-nagre-hk]	cislocative-they(fe/males).a-live.stative-former
tgáenagreˀ	'where they females or mixed live over there'	[t-gáe-nagre-ˀ]	cislocative-they(fe/males).a-live-stative
tgiˀdrǫ́:daˀk	'where I lived'	[t-g-iˀdrǫ́:-d-a-ˀ-k]	cislocative-I.a-live.stative-pronunciation.d-joinerA-causative-former
agadowihshę́:daˀk	'I did have a rest'	[ag-ad-owihshę́:-d-a-ˀ-k]	I.o-semireflexive-rest.stative-pronunciation.d-causative-former
agadowíshęˀ	'I have rested'	[ag-ad-owíshę-ˀ]	I.o-semireflexive-rest-stative
agawęgę́hę:ˀ	'it used to be mine'	[ni:ˀ] ‘I’ [ag-aw-ę-gę́hę:ˀ]	I.o-own-stative-past
agá:węh	'mine'	[ag-á:w-ęh]	I.o-own-stative
hó:węh	'his'	[hó:-w-ęh]	he.o-own-stative
howę́hne:ˀ	'it used to be his'	[ho-w-ę́-hne:ˀ]	he.o-own-stative-remote
hó:węh	'it is his'	[hó:-w-ęh]	he.o-own-stative
ęwaga̲hyá:gwę:k	'I will have picked fruit'	[ę-wag-a̲hy-á:-gw-ę-:k]	future-I.o-fruit-joinerA-pick-stative-modalizer
agáhyagwęh	'I have picked fruit'	[ag-áhy-a-gw-ęh]	I.o-fruit-joinerA-pick-stative
ęgáˀnikǫ:k	‘it will be sewn’	[ę-gá-ˀnikǫ-:k]	future-it.a-sew.stative-modalizer
ga̲ˀní:kǫˀ	‘a seam’	[ga̲-ˀní:kǫ-ˀ]	it.a-sew-stative
ęwagatǫ́:de:k	'I will be hearing it'	[ę-wag-atǫ́:de-:k]	future-I.o-hear.stative.modalizer
aǫdagaená:gre:k	‘they would live there’	[ǫ:da-gae-ná:gr-e-:k]	indefinite.cislocative-they(fe/males).a-live-go-modalizer
tgáenagrehk	‘they did or used to live there’	[t-gáe-nagre-hk]	cislocative-they(fe/males).a-live-go-former
ęyagodeˀnyędę́hsdǫ̲hǫ:k	‘she will be measuring things’	[ę-yago-d-e-ˀnyędę́hsd-ǫ̲h-ǫ-:k]	future-she.o-semireflexive-joinerE-measure-stative-joinerA-modalizer
wadeˀnyędę́hsdǫh	‘the act of measuring’	[w-ad-e-ˀnyędę́hsd-ǫh]	it.a-semireflexive-joinerE-measure-stative
dęgagwatwę́hę:k	‘it will be hemmed’	[d-ę-ga-gwatw-ę́h-ę-:k]	dualic-future-it.a-hem-stative-joinerA-modalizer
degágwatwęh	‘a hem’	[de-gá-gwatw-ęh]	dualic-it.a-hem-stative
ęsade̲hsrǫni̲hsˀǫ́hǫ:k	'you will be ready'	[ę-s-ad-e̲-hsrǫni̲hsˀ-ǫ́h-ǫ:k]	future-you(one).o-semireflexive-joinerE-ready-stative-modalizer
sadehsrǫníhsˀǫh	'you are ready'	[s-ad-e-hsrǫníhsˀ-ǫh]	you(one).o-semireflexive-joinerE-ready-stative
ęyagǫnhehgǫ̲hǫ:k	'they (literally, she) will live on', 'what will sustain them'	[ę-yag-ǫnhehg-ǫ̲h-ǫ-:k]	future-she.o-be.sustained-stative-joinerA-modalizer
agǫ́nhehgǫh	'someone lives on it', 'she is sustained by it'	[ag-ǫ́nhehg-ǫh]	she.o-be.sustained-stative
a:waga:tró:wi:k	'I should be talking about it'	[a:-wag-a:t-hró:wi-:-k]	indefinite-I.o-semireflexive-tell-stative-modalizer
aga:tró:wi:	'I have told'	[ag-a:t-hró:wi-:]	I.o-semireflexive-tell-stative
ęwagatrówi̲ha:k	'I will be talking about it'	[ę-wag-at-hrówi̲-h-a-:k]	future-I.o-semireflexive-tell-pronunciation.h-joinerA-modalizer
aga:tró:wi:	'I have told'	[ag-a:t-hró:wi-:]	I.o-semireflexive-tell-stative
osdagwáęsgǫ:	'it gets dirty easily'	[o-sdagw-á-ę-sgǫ:]	it.o-dirt-joinerA-lie.stative-facilitative
aˀosdagwáęh	'it got dirty, it gets dirty'	[aˀ-o-sdagw-á-ę-h]	factual-it.o-dirty-joinerA-lie-habitual
hodędǫnyáˀdǫ̲hsgǫ:	'he is a joker, or happy-go-lucky'	[ho-dę-dǫnyáˀd-ǫ̲h-sgǫ:]	he.o-semireflexive-make.fun-stative-facilitative
hodędǫnyáˀdǫh	'he is making fun of something'	[ho-dę-dǫnyáˀd-ǫh]	he.o-semireflexive-make.fun-stative
sadahǫdǫ́sgǫ:	'you are inquisitive’	[s-ad-ahǫdǫ́-sgǫ:]	you(one).a-semireflexive-ask-habitual.facilitative
sadahǫ́:dǫ:	'you ask'	[s-ad-ahǫ́:dǫ:]	you(one).a-semireflexive-ask-no.aspect
ohsdáhaˀge:	'it is really crying'	[o-hsdá-haˀ-ge:]	it.o-cry-habitual-augmentative
ga̲hsdá:haˀ	'I amcrying'	[g-a̲hsdá:-haˀ]	I.a-cry-habitual
ęhsa:tgwé:niˀ	'you will win'	[ę-hs-a:t-gwé:ni-ˀ]	future-you(one).a-semireflexive-compete-punctual
ganǫ́hsotge:	'it is a standing big house'	[ga-nǫ́hs-ot-ge:]	it.a-house-stand.stative-augmentative
ganǫ́hso:t	'it is a standing house'	[ga-nǫ́hs-o:t]	it.a-house-stand.stative
í:geˀ	'I am walking, moving'	[í:-g-e-ˀ]	prothetic-I.a-go-aspect
hǫwáhnǫdreˀ	'someone is following him'	[hǫwá-hnǫdr-e-ˀ]	they:him-follow-go-aspect
agékdǫ̲hneˀ	'I amgoing to see it'	[agé-kdǫ̲-hn-e-ˀ]	I.o-examine-dislocative-go-aspect
hǫwahnǫdrá:gyeˀ	'someone is following him along'	[hǫwa-hnǫdr-á:gy-e-ˀ]	they:him-follow-progressive-go-aspect
haˀgeˀ	‘I amgoing there’	[haˀ-g-e-ˀ]	translocative(there)-I.a-go-aspect
iheˀs	'he is here'	[i-h-e-ˀs]	prothetic-he.a-go-habitual
ęhsne:ˀ	'you two will go together'	[ę-hsn-e-:-ˀ]	future-you(two).a-go-purposive-punctual
í:geˀ	'I am walking, moving'	[í:-g-e-ˀ]	prothetic-I.a-go-stative
dagę́:neˀ	'they (z) are coming'	[da-gę́:n-e-ˀ]	cislocative-they(animals)/objects.a-go-stative
itseˀs	'you wander (all the time); you are over there'	[ę:] side [tsǫ:] just [i-t-s-e-ˀs]	prothetic-cislocative-you(one).a-go-habitual
ętseˀ	'you will wander'	[ę:] side [tsǫ:] just [ę-t-s-e-ˀ]	future-cislocative-you(one).a-go-punctual
itseˀ	'you are wandering (right now)'	[ę:] side [tsǫ:] just [i-t-s-e-ˀ]	prothetic-cislocative-you(one).a-go-stative
nǫdá:ge:ˀ	'I come from; I came from'	[nǫdá:-g-e-:-ˀ]	partitive.cislocative-I.a-go-purposive-punctual
naˀdę́:tge:ˀ	'I will come back over here, return'	[naˀdę́:t-g-e-:-ˀ]	partitive.dualic.future.cislocative-I.a-go-purposive-punctual
ihsgeˀs	'I have returned home'	[i-hs-g-e-ˀs]	prothetic-repetitive-I.a-go-habitual
ihsgeˀ	'I amgoing back, I amon my way back; I amback (from where I came)'	[i-hs-g-e-ˀ]	prothetic-repetitive-I.a-go-stative
haˀge:ˀ	'I went there'	[haˀ-g-e-:-ˀ]	translocative.factual-I.a-go-purposive-punctual
haˀgeˀ	'I am going (there)'	[haˀ-g-e-:-ˀ]	translocative.factual-I.a-go-punctual
hęhsge:ˀ	'I am going back there'	[hęhs-g-e-:-ˀ]	translocative.future.repetitive-I.a-go-purposive-punctual
iheˀs	'he is here’	[i-h-e-ˀs]	prothetic-he.a-go-habitual
itseˀs	'you wander’ (all the time); ‘you are over there’	[ę:] side [tsǫ:] just [i-t-s-e-ˀs]	prothetic-cislocative-you(one).a-go-habitual
gę́:neˀs	'they (z) are around’; ‘they are here’; ‘they are together’	[gę́:n-e-ˀs]	they(animals)/objects.a-go-habitual
tgę́:neˀs	'they (z) are over there’	[t-gę́:n-e-ˀs]	cislocative-they(animals)/objects.a-go-habitual
itgeˀs	'I amhere’	[i-t-g-e-ˀs]	prothetic-cislocative-I.a-go-habitual
heheˀs	'he is there’	[he-h-e-ˀs]	translocative-he.a-go-habitual
isgeˀs	'I have returned home’	[i-s-g-e-ˀs]	prothetic-repetitive-I.a-go-habitual
tigáęˀs	'they (f/m) are roaming about’	[ti-gáę-ˀs]	contrastive-they(f/m).go-habitual
tí:weˀs	' a stray (animal)’	[tí:-w-e-ˀs]	contrastive-it.a-go-habitual
iheˀs	‘he is here’	[i-h-e-ˀs]	prothetic-he.a-go-habitual
dagę́:neˀ	'they (z) are coming’	[da-gę́:n-e-ˀ]	cislocative.factual-they(animals)/objects.a-go-punctual
dǫdáheˀ	'he is coming back’	[dǫdá-h-e-ˀ]	dualic.factual.cislocative-he.a-go-punctual
haˀseˀ	'you are going’	[haˀ-s-e-ˀ]	translocative.factual-you(one).a-go-punctual
haˀgę́:neˀ	'they (z) are going’	[haˀ-gę́:n-e-ˀ]	translocative.factual-they(animals)/objects.a-go-punctual
haˀgáęˀ	'they (f/m) are going’	[haˀ-gáę-ˀ]	translocative.factual-they(fe/males).a-punctual
edwe:ˀ	'we all went together’	[e-dw-e-:-ˀ]	factual-we.all.inclusive.a-go-purposive-punctual
haˀá:kne:ˀ	'we two went’	[haˀ-á:kn-e-:-ˀ]	factual-we.two.exclusive.a-go-purposive-punctual
hǫsá:kne:ˀ	'we two went back’	[hǫsá:-kn-e-:-ˀ]	translocative.factual.repetitive-we.two.exclusive.a-go-purposive-punctual
hǫsá:ge:ˀ	'I did go again’	[to] there [hǫsá:-g-e-:-ˀ]	translocative.factual.repetitive-I.a-go-purposive-punctual
nǫdá:kne:ˀ	'where we two came from’	[nǫdá:-kn-e-:-ˀ]	partitive.cislocative.factual-we.two.exclusive.a-go-purposive-punctual
nǫdá:ge:ˀ	'I come from’; ‘I came from’	[nǫdá:-g-e-:-ˀ]	partitive.cislocative.factual-I.a-go-purposive-punctual
ętseˀ	'you will wander’	[ę:] side [tsǫ:] just [ę-t-s-e-ˀ]	future-cislocative-you(one).a-go-punctual
ętheˀ	'he will come this way’	[ę-t-h-e-ˀ]	future-cislocative-he.a-go-punctual
dętgeˀ	'I will come this way’; ‘I will come back’; ‘I am coming back’	[d-ę-t-g-e-ˀ]	dualic-future-cislocative-I.a-go-punctual
ętgeˀ	'I will come’	[ę-t-g-e-ˀ]	future-cislocative-I.a-go-punctual
ętgaęˀ	'they (f/m) will come’	[ę-t-gaę-ˀ]	future-cislocative-they(fe/males).a-punctual
dęgyá:kneˀ	'we two will come back’	[d-ę-g-yá:kn-e-ˀ]	dualic-uture-cislocative-we.two.exclusive.a-go-punctual
hę́:geˀ	'I will go’	[hę́:-g-e-ˀ]	translocative-future-I.a-go-punctual
hę́:ge:ˀ	'I will go there’	[hę́:-g-e-:-ˀ]	translocative.future-I.a-go-purposive-punctual
naˀdę́:tge:ˀ	'I will come back over here, return’	[naˀdę́:t-g-e-:-ˀ]	partitive.dualic.future.cislocative-I.a-go-purposive-punctual
hęhsge:ˀ	'I am going back there’	[hęhs-g-e-:-ˀ]	translocative.future.repetitive-I.a-go-purposive-punctual
hęhsge:ˀ	'I will go again’	[to] there [e:] again [hęhs-g-e-:-ˀ]	translocative.future.repetitive-I.a-go-purposive-punctual
ędwe:ˀ	'we will go together’	[ę-dw-e-:-ˀ]	future-we.all.inclusive.a-go-purposive-punctual
ęhsne:ˀ	'you two will go together’	[ę-hsn-e-:-ˀ]	future-you(two).a-go-purposive-punctual
hęhé:ˀ	‘he went there’	[h-ę-h-e-:-ˀ]	translocative-future-he.a-go-purposive-punctual,
aǫdá:geˀ	'I should come’	[aǫdá:-g-e-ˀ]	indefinite.cislocative-I.a-go-punctual
naˀdǫ́:da̲heˀ	'he would come this way’	[naˀdǫ́:da̲-h-e-ˀ]	partitive.dualic.indefinite.cislocative-he.a-go-punctual
dǫdá:kneˀ	'we two would come back’	[dǫdá:-kn-e-ˀ]	dualic.indefinite.cislocative-we.two.exclusive.a-go-punctual
há:ge:ˀ	'I should go there’	[há:-g-e-:-ˀ]	translocative.indefinite-I.a-go-purposive-punctual
hǫsá:ge:ˀ	'I would go again’	[to] there [e:] again [hǫsá:-g-e-:-ˀ]	translocative.repetitive.indefinite-I.a-go-purposive-punctual
á:yakne:ˀ	'we two would go together’	[á:-yakn-e-:-ˀ]	indefinite-we.two.exclusive.a-go-purposive-punctual
í:geˀ	'I am walking, moving’	[í:-g-e-ˀ]	prothetic-I.a-go-stative
agéhseˀ	‘I am riding’	[agé-hs-e-ˀ]	I.o-lower.back-go-stative
agéhse:ˀ	‘I rode’, ‘I came riding’	[agé-hs-e-:-ˀ]	I.o-lower.back-go-purposive-stative
khrę́:deˀ	‘I lead, go in front’	[k-hrę́:d-e-ˀ]	I.a-lead-go-aspect
kdákseˀ	‘I am running’	[k-dáks-e-ˀ]	I.a-run-go-aspect
gehsreˀ	‘I am chasing it’	[ge-hsr-e-ˀ]	I.a-follow-go-aspect
agéˀdreˀ	‘I am riding along’	[agé-ˀdr-e-ˀ]	I.a-ride-go-aspect
gyená:greˀ	‘she lives, stays, dwells over there’; ‘people live over there’	[g-ye-ná:gr-e-ˀ]	cislocative-she.a-dwell-go-aspect
grá:deˀ	‘I climb’	[g-rá:d-e-ˀ]	I.a-climb-go-aspect
hǫwáhnǫdreˀ	‘someone is following him’	[hǫwá-hnǫdr-e-ˀ]	someone:him-follow-go-aspect
deyagodáwęnyeˀ	‘she is walking’	[de-yago-d-áwęny-e-ˀ]	dualic-she.o-semireflexive-stir-go-aspect
hadíhsreˀ	‘they follow, chase’	[had-íhsr-e-ˀ]	they(males).a-follow-go-aspect
gathahí:neˀ	‘I amwalking’	[g-at-hah-í:n-e-ˀ]	I.a-semireflexive-road-move-go-aspect
degagyohsgwí:neˀ	‘I am crawling’	[de-g-ag-yohsgw-í:n-e-ˀ]	dualic-I.a-semireflexive-elbow-move-go-aspect
gǫnę:tsí:neˀ	‘I amleading you by the hand’	[gǫ-nę:ts-í:n-e-ˀ]	I:you-arm-move-go-aspect
hohseˀ	‘he is riding a horse’	[ho-hs-e-ˀ]	he.o-lower.back-go-aspect
nyo:weˀ	‘how far (distance)’; ‘to be a certain distance’	[ni-yó:-w-e-ˀ]	partitive-it.o-distance/amount-go-aspect
khá:wiˀ	‘I am carrying it’	[k-há:w-i-ˀ]	I.a-hold-go-aspect
agéhseˀ	‘I am riding’	[agé-hs-e-ˀ]	I.o-lower.back-go-stative
agéhse:ˀ	‘I rode’, ‘I came riding’	[agé-hs-e-:-ˀ]	I.o-lower.back-go-purposive-stative
gegyeˀ	‘I am flying’	[ge-gy-e-ˀ]	I.a-fly-go-stative
gegye:ˀ	‘I came flying’	[ge-gy-e-:-ˀ]	I.a-fly-go-purposive-stative
kdakseˀ	‘I am running’	[k-daks-e-ˀ]	I.a-run-go-stative
kdakse:ˀ	‘I was running’	[k-daks-e-:-]	I.a-run-go-purposive-stative
ge̲hsreˀ	‘I am chasing it’	[ge̲-hsr-e-ˀ]	I.a-follow-go-stative
ge̲hsre:ˀ	‘I was chasing it’	[ge-hsr-e-:-ˀ]	I.a-follow-go-purposive-stative
gatahí:neˀ	‘I amwalking’	[g-at-hah-í:n-e-ˀ]	I.a-semireflexive-road-lead-go-stative
degagyo̲hsgwí:neˀ	‘I am crawling’	[de-g-ag-yo̲hsgw-í:n-e-ˀ]	dualic-I.a-semireflexive-elbow-follow-go-stative
degagyo̲hsgwí:ne:ˀ	‘I was crawling’	[de-g-ag-yo̲hsgw-í:n-e-:-ˀ]	dualic-I.a-semireflexive-elbow-follow-go-purposive-stative
krę́:deˀ	‘I lead, go in front’	[k-hrę́:d-e-ˀ]	I.a-lead-go-stative
krę́:de:ˀ	‘I lead, went in front’	[k-hrę́:d-e-:-ˀ]	I.a-lead-go-purposive-stative
grá:deˀ	‘I climb’	[g-rá:d-e-ˀ]	I.a-climb-go-stative
grá:de:ˀ	‘I climbed’	[g-rá:d-e-:-ˀ]	I.a-climb-go-purposive-stative
ká:wi:ˀ	‘I was carrying it’	[k-há:w-i-:-ˀ]	I.a-carry-go-purposive-stative
krę́:dehk	‘I led, went in front’	[k-hrę́:d-e-hk]	I.a-lead-go-former
krę́:de:ˀ	‘I led, went in front’	[k-hrę́:d-e-:-ˀ]	I.a-lead-go-purposive-stative
grá:dehk	‘I climbed’	[g-rá:d-e-hk]	I.a-climb-go-former
grá:de:ˀ	‘I climbed’	[g-rá:d-e-:-ˀ]	I.a-climb-go-purposive-stative
tgáenagrehk	‘they did or used to live there’	[t-gáe-nagre-hk]	cislocative-they(fe/males).a-live-former
tgaenagréˀgę̲hę:ˀ	‘they used to live there’	[t-gae-nagré-ˀ-gę̲hę:ˀ]	cislocative-they(fe/males).a-live-stative-past
tgáenagreˀ	‘they live there’	[t-gáe-nagre-ˀ]	cislocative-they(fe/males).a-live-stative
agékdǫ̲-hneˀ	'I amgoing to see it'	[a-gé-kdǫ̲-hn-e-ˀ]	factual-I.a-examine-dislocative-go-stative
ęgékdǫ̲-hnaˀ	'I will go see'	[ę-gé-kdǫ̲-hn-aˀ]	future-I.a-examine-dislocative-punctual
ęgékdǫ:ˀ	'I will see, look'	[ę-gé-kdǫ-:ˀ]	future-I.a-examine-punctual
gadáhnyo̲hneˀs	'to fish continuously'	[g-ad-áhny-o̲-hn-e-ˀs]	I.a-semireflexive-hook-put.in.water-dislocative-go-habitual
hatrǫnya̲hnéˀsgę̲hę:ˀ	'he used to tell'	[h-at-hrǫny-a̲hn-é-ˀs-gę̲hę:ˀ]	he.a-semireflexive-tell-dislocative-go-habitual-past
ęgahyagwáhse:k	'I will be a fruit picker'	[ę-g-ahya-gw-áhs-e-:k]	future-I.a-fruit-pick-dislocative-go-modalizer
ętayętwáhse:k	'he will be planting over there'	[ę-t-ha-yętw-áhs-e-:k]	future-cislocative-he.a-plant-dislocative-go-modalizer
a:ga̲hyágwa̲hse:k	'I might be a fruit picker'	[a:-g-a̲hyá-gw-a̲hs-e-:k]	indefinite-I.a-fruit-pick-dislocative-go-modalizer
ǫ:tayę́twa̲hse:k	'he would be planting over there'	[ǫ:-t-ha-yętw-a̲hs-e-:k]	indefinite-cislocative-he.a-plant-dislocative-go-modalizer
tsǫ:	'just let him keep planting'	[a:-ha-yętw-a̲hs-é-:k tsǫ:]	indefinite-he.a-plant-dislocative-go-modalizer
gatrǫ́nya̲hneˀ	'I have come here to tell'	[g-at-hrǫ́ny-a̲hn-e-ˀ]	I.a-semireflexive-tell-dislocative-go-stative
ǫdéˀdǫ̲hneˀ	'she is about to give birth'	[ǫ-dé-ˀdǫ̲-hn-e-ˀ]	she.a-semireflexive-be.due
ęyǫ́de̲ˀdǫ:ˀ	'when she will be due'	[ę-yǫ́-de-ˀdǫ-:ˀ]	future-she.a-semireflexive-be.due-punctual
de̲hęnatgwáhneˀ	'they (m) are going to dance'	[de̲-hęn-at-gw-áhn-e-ˀ]	dualic-they(males).a-semireflexive-dance-dislocative-go-stative
de̲hohedáhneˀ	'he is going along hollering'	[de̲-ho-hed-áhn-e-ˀ]	dualic-he.o-yell-dislocative-go-stative
de̲hóhethaˀ	'he is hollering'	[de̲-hó-het-haˀ]	dualic-he.o-yell-habitual
gatrǫ́nya̲hne:ˀ	'I came and told'	[g-at-hrǫ́ny-a̲hn-e-:-ˀ]	I.a-semireflexive-tell-dislocative-go-purposive-stative
ohsdéhsdǫh	'it has evaporated, all dried up'	[o-hsdéhsd-ǫh]	it.o-evaporate-stative
sa̲hohdęgyǫ́hǫgyeˀ	'he is on his way home'	[sa̲-ho-hdęgy-ǫ́h-ǫgy-e-ˀ]	repetitive-he.o-leave-stative-progressive-go-stative
hesáhdęgyǫ:	'you went over there'	[he-s-áhdęgy-ǫ:]	translocative-you(one).o-leave-stative
otsihsˀǫ̲hǫ́:gyeˀ	'it is getting mature’	[o-tsihsˀ-ǫ̲h-ǫ́:gy-e-ˀ]	it.o-mature-stative-progressive-go-stative
otsíhsˀǫh	'it is done for the season', 'it has gone full cycle', 'it is mature', 'they (plants) have finished out'	[o-tsíhsˀ-ǫh]	it.o-mature-stative
hodǫgo̲hdǫ́hǫgyeˀ	'he is going along passing’	[ho-d-ǫgo̲hd-ǫ́h-ǫgy-e-ˀ]	he.o-semireflexive-surpass-stative-progressive-go-stative
hodǫ́go̲hdǫh	'he has gone past'	[ho-d-ǫ́go̲hd-ǫh]	he.o-semireflexive-surpass-stative
go̲hdogadǫ́-ǫgyeˀ	'she is growing something’	[go̲-hdogad-ǫ́h-ǫgy-e-ˀ]	she.o-cause.to.grow-stative-progressive-go-stative
ǫgahdǫgáˀdǫh	'she (e.g., a guardian) raised me'	[ǫg-ahǫgáˀd-ǫh]	she:me-raise-stative
odaˀgra̲hdǫ́hǫgyeˀ	'it is surfacing’	[o-d-aˀgra̲hd-ǫ́h-ǫgy-e-ˀ]	it.o-semireflexive-float-stative-progressive-go-stative
odáˀgra̲hdǫh	'it is floating'	[o-d-áˀgra̲hd-ǫh]	it.o-semireflexive-float-stative
agade̲ˀgwę́hęgyeˀ	'I am running away again’	[ag-ade̲-ˀgw-ę́h-ęgy-e-ˀ]	I.o-semireflexive-run.away-stative-progressive-go-stative
da̲hodawę́hęgyeˀ	'he is swimming towards us’	[da̲-ho-d-awę́h-ęgy-e-ˀ]	cislocative-he.o-semireflexive-swim-stative-progressive-go-stative
hodá:węh	'he did swim'	[ho-d-á:w-ęh]	he.o-semireflexive-swim-stative
go̲hsganye̲há:gyeˀ	'she is shuffling along’	[go̲-hsganye̲-h-á:gy-e-ˀ]	she.o-shuffle-pronunciation.h-progressive-go-stative
gohsga:nye:ˀ	'she has shuffled’	[go-hsgá:nye-:ˀ]	she.o-shuffle-stative
sagawe̲há:gyeˀ	'you are paddling along’	[sa-gawe̲-h-á:gy-e-ˀ]	you(one).o-paddle-pronunciation.h-progressive-go-stative
agyǫdi̲há:gyeˀ	'I am going along smiling'	[ag-yǫdi̲-h-á:gy-e-ˀ]	I.o-smile-pronunciation.h-progressive-go-stative
hoyǫ́gyǫ̲hne:ˀ	'he has already smiled; he did smile'	[ho-yǫgy-ǫ̲-hne:ˀ]	he.o-smile-stative-remote
ęjisadekǫníhagyeˀ	'you can (literally, 'will') eat while you are going along’	[ę-ji-s-ade-k-ǫní-h-agy-e-ˀ]	future-repetitive-you(one).o-semireflexive-food-make-pronunciation.h-progressive-go-stative
hode:kǫ́:ni:	'he is eating'	[ho-de:-k-ǫ́:ni-:]	he.o-semireflexive-food-make-stative
gaǫhyadá:gyeˀ	'on-going skies, heavens, skyline, horizon'	[ga-ǫhya-d-á:gy-e-ˀ]	it.a-sky-stand.stative-progressive-go-stative
onǫnyáędagyeˀ	'it is freezing’	[o-nǫnyá-ę-d-agy-e-ˀ]	it.o-ice-lie.stative-pronunciation.d-progressive-go-stative
onǫ́nyaęˀ	'it is frozen'	[o-nǫ́nya-ęˀ]	it.o-ice-lie.stative
awęnowaędá:gyeˀ	'it is sinking'	[aw-ęnowa-ę-d-á:gy-e-ˀ]	it.o-sink-lie.stative-pronunciation.d-progressive-go-stative
ęwęnǫwáęˀ	'it will sink'	[w-ęnǫwá-ę-ˀ]	future-it.a-sink-lie.stative-punctual
degahsdę̲hódagyeˀ	'mountain range, the Rockies'	[de-ga-hsdę̲h-ód-agy-e-ˀ]	dualic-it.a-stone-standing.stative-progressive-go-stative
gajiˀdodá:gyeˀ	'someone is going along crying'	[ga-jiˀd-od-á:gy-e-ˀ]	it.a-cry-standing.stative-progressive-go-stative
gajíˀdo:t	'it is crying'	[ga-jíˀd-o:t]	it.a-cry-standing.stative
desatnǫ̲hweˀtsodá:gyeˀ	'you are going along doing handstands'	[de-s-at-nǫ̲hweˀts-od-á:gy-e-ˀ]	dualic-you(one).a-semireflexive-noun-standing.stative-progressive-go-stative
dewaˀdęhǫ́dagyeˀ	'wood fence, rail and stump fence'	[de-w-aˀdęh-ǫ́d-agy-e-ˀ]	dualic-it.a-fence-rooted.stative-progressive-go-stative
honhǫ́dagyeˀ	'he has it in his mouth as he moves'	[ho-nhǫ́d-agy-e-ˀ]	he.o-opening-progressive-go-stative
odóˀkdagyeˀ	'rim, outer and inner rim splint; along the edge'	[o-d-óˀkd-agy-e-ˀ]	it.o-semireflexive-end.stative-progressive-go-stative
ǫgyaˀda̲hshęˀǫhǫ́:gyeˀ	‘I am arriving late’	[ǫg-yaˀd-a̲hshęˀ-ǫh-ǫ́:gy-e-ˀ]	factual.I.o-body-slow-stative-progressive-go-punctual
ǫgyáˀda̲hshęˀ	‘I was late’	[ǫg-yáˀd-a̲hshę-ˀ]	factual.I.o-body-slow-punctual
ęyago̲hdogadǫ́hǫgyeˀ	‘she will be continually growing it or them’	[ę-yago̲-hdogad-ǫ́h-ǫgy-e-ˀ]	future-she.o-cause.to.grow-stative-progressive-go-punctual
ęwaga̲hyagǫ̲hǫ́:gyeˀ	‘I will be eating fruit as I am going along’	[ę-wag-a̲hya-g-ǫ̲h-ǫ́:gy-e-ˀ]	future-I.o-fruit-eat-stative-progressive-go-stative
a:wagahyagwę́hęgyeˀ	‘I should be picking fruit along’	[a:-wag-ahya-gw-ę́h-ęgy-e-ˀ]	indefinite-I.o-fruit-pick-stative-progressive-go-punctual
deyǫkiyęˀnyadǫ́hǫgyeˀs	‘they protect us’	[de-yǫkiy-ę-ˀnya-d-ǫ́h-ǫgy-e-ˀs]	dualic-they:us-semireflexive-hand-stand-stative-progressive-go-habitual
deyǫkiyę́ˀnyadǫˀ	‘they protect us with their hands’; ‘angels’	[de-yǫkiy-ę́-ˀnya-d-ǫˀ]	dualic-they:us-semireflexive-hand-stand.stative-plural
honadahsehdǫ̲hǫ́:gyeˀs	‘they (m) are sneaking around’	[hon-ad-ahsehd-ǫ̲h-ǫ́:gy-e-ˀs]	they(males).o-semireflexive-hide-stative-progressive-go-habitual
agada̲hséhdǫh	‘I am hiding now’	[ag-ad-a̲hséhd-ǫh]	I.o-semireflexive-hide-stative
agahyagwę́hęgyeˀs	‘I amgoing along picking fruit all over the place’	[ag-ahya-gw-ę́h-ęgy-e-ˀs]	I.o-fruit-pick-stative-progressive-go-habitual
agahyagwę́hęgyeˀ	‘I amgoing along picking fruit’	[ag-ahya-gw-ę́h-ę-gy-e-ˀ]	I.o-fruit-pick-stative-progressive-go-stative
sadeˀgwę̲hę́:gyeˀs	‘you are avoiding’	[sa-de-ˀgw-ę̲h-ę́:gy-e-ˀs]	you(one).o-semireflexive-flee-stative-progressive-go-habitual
ęhsáde̲ˀgoˀ	‘you will flee, run away’	[ę-hs-áde̲-ˀgo-ˀ]	future-you(one).a-semireflexive-flee-punctual
deyǫgwa̲hgwę́hęgyeˀs	‘we all are continually picking it up’	[de-yǫgw-a̲hgw-ę́h-ęgy-e-ˀs]	dualic-we.all.o-pick.up-stative-progressive-go-habitual
de̲hoya̲ˀdáhgwęh	‘it picked him up’	[de̲-ho-ya̲ˀd-áhgw-ęh]	dualic-he.o-body-pick.up-stative
tiwa:gǫ́:ni:	‘I have made it in place of something else, replaced it’	[ti-wa:g-ǫ:ni-:]	contrastive-I.o-make-stative
ga̲hyagwę̲hęgye̲ˀsgę́hę:ˀ	'I used to be a fruit picker'	[g-a̲hya-gw-ę̲h-ęgy-e̲-ˀs-gę́hę:ˀ]	I.a-fruit-pick-stative-progressive-go-habitual-past
a:wagahyagwęhęgyéˀse:k	'I would (still) have been picking fruit…'	[a:-wag-ahya-gw-ęh-ęgy-é-ˀs-e:k]	indefinite-I.o-fruit-pick-stative-progressive-go-habitual-modalizer
ęgǫnętsí:neˀ	‘I will lead you by the hand’	[ę-gǫ-nęts-í:n-e-ˀ]	future-I:you-arm-lead-go-aspect
ękǫ́ˀji̲hneˀ	'I am going to get dark'	[ę-k-hǫ́ˀji̲-hn-e-ˀ]	future-I.a-dark-dislocative-go-aspect
akǫ́ˀji̲hneˀ	‘I got dark, black (really tanned)’	[a-k-hǫ́ji̲-hn-e-ˀ]	factual-I.a-dark-dislocative-go-aspect
ga̲hǫ́ˀji:	‘it is dark-coloured’	[ga̲-hǫ́ˀji-:]	it.a-dark-stative
ękrę́:dehk	‘I will lead, go in front’	[ę-k-hrę́:d-e-hk]	future-I.a-lead-go-former
krę́:dehk	‘I led, went in front’	[k-hrę́:d-e-hk]	I.a-lead-go-former
ęgrá:de-hk	‘I will climb’	[ę-g-rá:d-e-hk]	future-I.a-climb-go-former
grá:de-hk	‘I climbed’	[g-rá:d-e-hk]	I.a-climb-go-former
de̲ˀagyade:kǫ́:nih	‘we two do not eat’	[tęˀ de̲ˀ-agy-ade:-kǫ́:ni-h]	negative-we.two.exclusive.a-semireflexive-eat-habitual
de̲ˀaknigǫháędaˀs	‘I do not understand’	[tęˀ] not [de̲ˀ-ak-nigǫháęd-a-ˀs]	negative-I.o-understand-joinerA-habitual
aknigǫ̲háędaˀs	‘I understand’	[ak-nigǫ̲háęd-a-ˀs]	I.o-understand-joinerA-habitual
degé:gęhs	‘I do not see things’	[tęˀ] not [de-gé:-gę-hs]	negative-I.a-see-habitual
de̲ˀa:kní:nǫh	‘I did not buy it’	[tęˀ] not [de-wa:k-hní:nǫ-h], [tęˀ] not [de̲ˀ-a:k-hní:nǫ-h]	negative-I.o-buy-stative
akní:nǫh	‘I did buy it’	[ak-hní:nǫ-h]	I.o-buy-stative
degá:nǫ:ˀ	‘it is not costly’	[tęˀ] not [de-gá:-nǫ:ˀ]	negative-it.a-costly.stative
ganǫ:ˀ	‘it is expensive, dear, precious’	[ga-nǫ:ˀ]	it.a-costly.stative
de̲hóyętwęh	‘he did not plant’	[tęˀ] not [de̲-hó-yętw-ęh]	negative-he.o-plant-stative
aháyętoˀ	‘he did plant’	[a-há-yęto-ˀ]	factual-he.a-plant-punctual
de̲hóyętwęh	‘he did not plant’	[tęˀ] not [de̲-hó-yętw-ęh]	negative-he.o-plant-stative
hoyę́:twęh	‘he is planting’	[ho-yę́:tw-ęh]	he.o-plant-stative
ta:gaesayę́:de:	‘they will not recognize you’	[tęˀ] not [t-a:-gaesa-yę́:de:-ø]	contrastive-indefinite-they:you-recognize-no.aspect
ęgyę́:de:ˀ	‘I will recognize it’	[ę-g-yę́:de:-ˀ]	future-I.a-recognize-punctual
ta:gé:gęh	‘I will not or should not see it’	[tęˀ] not [t-a:-gé:-gę-h]	contrastive-indefinite-I.a-see-no.aspect(pronunciation.h)
ęgé:gęˀ	‘I will see it’	[ę-gé:-gę-ˀ]	future-I.a-see-punctual
a:gatgáhtoh	‘I should (etc.) look at it’	[a:-g-at-gáhtoh]	indefinite-I.a-semireflexive-see.ø.punctual
ta:kní:nǫh	‘I should not or will not buy it’	[tęˀ] not [t-a:-k-hní:nǫ-h]	contrastive-indefinite-I.a-buy-pronunciation.h
e:hsní:nǫˀ	‘you will buy, purchase it’	[e:-hs-hní:nǫ-ˀ]	factual-you(one).a-buy-punctual
ta:gé:gęh	‘I will not or should not see it’	[tęˀ] not [t-a:-gé:-gę-h]	contrastive-indefinite-I.a-see-pronunciation.h
a:gé:gęˀ	‘I should (etc.) see it’	[a:-gé:-gę-ˀ]	indefinite-I.a-see-punctual
dewagatrowi̲há:gyeˀs	'I amnot going along telling here and there'	[tęˀ] not [de-wag-at-hrowi̲-h-á:-gy-e-ˀs]	negative-I.o-semireflexive-tell-pronunciation.h-joinerA-progressive-go-habitual
agatrowíhagyeˀs	'I amgoing along telling here and there'	[ag-at-hrowí-h-a-gy-e-ˀs]	I.o-semireflexive-tell-pronunciation.h-joinerA-progressive-go-habitual
deˀagatrówi̲hne:ˀ	'I haven't/hadn't told'	[tęˀ] not [deˀ-ag-at-hrówi̲-hne:ˀ]	negative-I.o-semireflexive-tell.stative-past
agatrowíhne:ˀ	'I have/had told'	[ag-at-hrowí-hne:ˀ]	I.o-semireflexive-tell.stative-past
ta:gatrówi̲ha:k	'I won't/wouldn't be a teller; I won't/wouldn't tell all the time'	[tęˀ] not [t-a:-g-at-hrówi̲-h-a-:k]	contrastive-indefinite-I.a-semireflexive-tell-pronunciation.h-joinerA-modalizer
ęgatrowíha:k	'I will be a teller, I'll tell all the time’	[ę-g-at-hrowí-h-a:-k]	future-I.a-semireflexive-tell-pronunciation.h-joinerA-modalizer
a:gatrówi̲ha:k	'I would be a teller; I would tell all the time'	[a:-g-at-hrówi̲-h-a-:k]	indefinite-I.a-semireflexive-tell-pronunciation.h-joinerA-modalizer
ta:wagatrowíha:k	'I wouldn't have told'	[tęˀ] not [t-a:-wag-at-hrowí-h-a-:k]	negative-indefinite-semireflexive-tell-pronunciation.h-joinerA-modalizer
ęwagatrówi̲ha:k	'I will have told'	[ę-wag-at-hrówi̲-h-a-:k]	future-I.o-semireflexive-tell-pronunciation.h-joinerA-modalizer
ta:waga:tró:wi:k	'I shouldn't have told'	[tęˀ] not [t-a:-wag-a:t-hró:wi-:k]	contrastive-indefinite-I.o-semireflexive-tell.stative-modalizer
a:waga:tró:wi:k	'I should have told'	[a:-wag-a:t-hró:wi-:k]	indefinite-I.o-semireflexive-tell.stative-modalizer
ta:gatrowi̲hágye̲ˀse:k	'I still wouldn't have been going along telling'	[tęˀ] not [t-a:-g-at-hrowi̲-h-á-gy-e̲-ˀs-e:k]	negative-indefinite-I.a-semireflexive-tell-pronunciation.h-joinerA-progressive-go-habitual-modalizer
ęwagatrowi̲hágye̲ˀse:k	'I will still have been going along telling'	[ę-wag-at-hrowi̲-h-á-gy-e̲-ˀs-e:k]	future-I.o-semireflexive-tell-pronunciation.h-joinerA-progressive-go-habitual-modalizer
a:wagatrowihagyéˀse:k	'I should still have been going along telling'	[a:-wag-at-hrowi-h-a-gy-é-ˀs-e:k]	indefinite-I.o-semireflexive-tell-pronunciation.h-progressive-habitual-modalizer
dewagatrowi̲há:gyeˀ	'I haven't gone along telling'	[tęˀ] not [de-wag-at-hrowi̲-h-á:-gy-e-ˀ]	negative-I.o-semireflexive-tell.stative-pronunciation.h-joinerA-progressive-go-stative
ǫgatrowíhagyeˀ	'I went along telling'	[ǫg-at-hrowí-h-a-gy-e-ˀ]	factual.I.o-semireflexive-tell-pronunciation.h-joinerA-progressive-go-punctual
sa̲hsnęht	‘get down from there’	[s-a̲hsnęht-ø]	you(one).a-descend-no.aspect
satgęh	‘get up’	[s-at-gęh-ø]	you(one).a-semireflexive-awaken-no.aspect
dwagáhdęgyǫ:	‘(where) I come from’	[d-wag-áhdęgy-ǫ:]	cislocative-I.o-leave-stative
dwada:dǫ́:nih	‘where it starts from’	[d-w-ada:d-ǫ́:ni-h]	cislocative-it.a-reflexive-make-habitual
dęyehgwa̲ˀdáhnǫ:ˀ	‘she will raise or lift things up’	[d-ę-ye-hgw-a̲-ˀd-á-hnǫ-:ˀ]	dualic-future-she.a-lift.up-joinerA-causative-joinerA-distributive-punctual
ęya:gó:da:ˀ	‘she will drape it’	[ę-ya:g-ó:da:-ˀ]	future-she/someone.a-drape-punctual
ęyé:gęˀ	‘she will see it’	[ę-yé:-gę-ˀ]	future-she/someone.a-see-punctual
a:yé:gęˀ	‘she might see it’	[a:-yé:-gę-ˀ]	indefinite-she/someone.a-see-punctual
aˀé:gęˀ	‘she did see it’	[aˀ-é:-gę-ˀ]	factual-she/someone.a-see-punctual
é:gęhs	‘she sees it’	[é:-gę-hs]	she/someone.a-see-habitual
aˀé:gęˀ	‘she saw it’	[aˀ-e:-gę-ˀ]	factual-she.a-see.punctual
aˀédagraˀ	‘she fell down’	[aˀ-e-(i)dagraˀ]	factual-she.a-fall.down.punctual
aˀǫdęnaˀtragwáhaˀ	‘she went after groceries’	[aˀ-ǫ-(a)dę-naˀtra-gwáha-ˀ]	factual-she.a-semireflexive-provisions-go.and.get-punctual
aˀǫniˀdé:niˀ	‘she farted’	[aˀ-ǫ-(ę)niˀde:niˀ]	factual-she.a-fart.punctual
dęyagodáihsiˀ	‘she undraped it’	[dę-yag-odaihsiˀ]	dualic.future-she.a-undrape.punctual
ęsę́:daˀ	‘you will sleep’	[ę-sa-idaˀ]	future-you(one).o-sleep-ø.punctual
ęyo:dí:daˀ	‘they will sleep, hibernate’	[ę-yo:dí:-(i)daˀ]	future-they(animals)/objects.o-sleep-ø.punctual
ęhsé:gęˀ	‘you will see it’	[ę-hsé:-gę-ˀ]	future-you(one).a-see-punctual
ęyé:gęˀ	‘she will see it’	[ę-yé:-gę-ˀ]	future-she/someone.a-see-punctual
ęhǫwadí:gęˀ	‘they or s/he will see him, them (m)’	[ę-hǫwadí:-gę-ˀ]	future-they:them(etc.)-see-punctual
aˀe:gęˀ	‘she saw it’	[aˀ-é:-gę-ˀ]	factual-she/someone.a-see-punctual
gé:gęhs	‘I see’	[gé:-gę-hs]	I.a-see-habitual
í:wi:	'I want, hope, think'	[í:-w-i:]	prothetic-I.a-think.stative
ęwa:gí:daˀ	‘I will sleep’	[ę-wa:g-í:daˀ]	future-I.o-sleep.punctual
agída̲ˀǫh	‘I was asleep’; ‘I am sleeping’	[ag-ída̲ˀ-ǫh]	I.o-sleep-stative
atóhe:t	‘he yelled’	[a-t-hó-he:t]	factual-dualic-he.o-yell-ø.punctual
atóhsi̲ha:ˀs	‘he choked’	[a-t-hó-hsi̲ha:ˀs]	factual-dualic-he.o-choke-ø.punctual
desáhsi̲ha:ˀs	‘you are choking’	[de-sá-hsi̲ha:ˀs]	dualic-you(one).o-choke-habitual
ǫgí:daˀ	‘I am sleeping’; ‘I slept’	[ǫg-í:daˀ]	factual.I.o-sleep.punctual
ęwa:gí:daˀ	‘I will sleep’	[ę-wa:g-í:daˀ]	future-I.o-sleep.punctual
á:se:k	'you should eat it'	[á:-s-e:-k]	indefinite-you(one).a-eat-ø.punctual
áedwe:ˀ	'we all should want, think'	[áe-dw-e:-ˀ]	indefinite-you(all).a-think-punctual
á:yagwe:ˀ	'we all should want, think'	[á:-yagw-e:-ˀ]	indefinite-s/he/they.and.I/we.a-think-punctual
ędihsa̲hsíˀgyaˀk	'you will stumble, stub your toe'	[ędi-s-ahsíˀg-yaˀk-ø]	future.cislocative-you(one).a-foot-break-ø.punctual
ętsnaˀgyę:ˀ	‘you will  imitate, mock, mimic, something’	[ę-t-s-naˀgyę:-ˀ]	future-cislocative-you(one).a-mock-punctual
adísaˀtsǫhs	'you sneezed'	[adi-sa-ˀtsǫhs]	factual.dualic-you(one).o-sneeze.ø.punctual
dęsáˀtsǫhs	'you will sneeze'	[d-ę-sá-ˀtsǫhs]	dualic-future-you(one).o-sneeze.ø.punctual
adígya̲ˀdraˀ	'we two met'	[adí-gy-a̲ˀdraˀ]	factual.dualic-you(one).and.I.a-meet.ø.punctual
atgáǫˀdraˀ	'they met'	[a-t-gáǫ-ˀdraˀ]	factual-dualic-they(fe/males).a-meet.ø.punctual
dǫdáęˀ	'she is coming back'	[dǫda-(y)e-e-ˀ]	dualic-factual-cislocative-she.a-go-punctual
dǫdá:geˀ	'I am coming back'	[dǫdá:-g-e-ˀ]	dualic-factual-cislocative-I.a-go-punctual
ętgáęˀ	'they (f/m) will come'	[ę-t-gae-e-ˀ]	future-cislocative-they(fe/males).a-go-punctual
ęteˀ	'he will come this way'	[ę-t-h-e-ˀ]	future-cislocative-he.a-go-punctual
haˀgáęˀ	'they (f/m) are going'	[haˀ-gae-e-ˀ]	translocative.factual-they(fe/males).a-go-punctual
haˀseˀ	'you are going'	[haˀ-s-e-ˀ]	translocative.factual-you-go-punctual
tigáęˀs	'they are roaming about'	[ti-gae-e-ˀs]	contrastive-they(fe/males).a-go-habitual
tí:wehs	'a stray animal'	[tí-w-e-hs]	contrastive-it.a-go-habitual
ęhtaˀ	‘she usually goes’	[e-eht-haˀ]	she.a-go-habitual
gehtaˀ	‘I usually go’	[g-eht-haˀ]	I.a-go-habitual
í:yęˀs	‘she is here’	[í:-ye-e-ˀs]	prothetic-she.a-go-habitual
i:geˀs	‘I am here’	[í:-g-e-ˀs]	prothetic-I.a-go-habitual
hę́:yę:ˀ	‘she will go there’	[h-ę́:-ye-e-:-ˀ]	translocative-future-she.a-go-purposive-punctual
hę́:ge:ˀ	‘I will go there’	[h-ę́:-g-e-:-ˀ]	translocative-future-I.a-go-purposive-punctual
ganǫ́hsaˀ	‘house’	[ga-nǫ́hs-aˀ]	it.a-house-noun.stem.former
onę́hę:ˀ	‘corn’	[o-nę́hę:-ˀ]	it.o-corn-noun.stem.former
ahdahgwáǫweh	‘shoe’, ‘moccasin’	[ahdahgw-á-ǫweh]	shoe-joinerA-typicalizer
ahdáhgwaˀ	‘shoe’	[ahdáhgw-aˀ]	shoe-noun.stem.former
onóˀjaˀ	‘tooth’	[o-nóˀj-aˀ]	it.o-tooth-noun.stem.former
ojíˀohdaˀ	‘fingernail’	[o-jíˀehd-aˀ, o-jíˀohd-aˀ]	it.o-fingernail-noun.stem.former
ogéˀa:ˀ	‘hair’, ‘a rag’	[o-géˀa:-ˀ]	it.o-hair-noun.stem.former
oˀdaˀ	‘feces’	[o-ˀd-aˀ]	it.o-feces-noun.stem.former
otsgraˀ	‘saliva’	[o-tsgr-aˀ]	it.o-saliva-noun.stem.former
ojínǫ̲hgraˀ	‘mucus’	[o-jínǫ̲hgr-aˀ]	it.o-mucus-noun.stem.former
onyáˀgwaˀ	‘vomit’, ‘vomitus’	[o-nyáˀgw-aˀ]	it.o-vomit-noun.stem.former
oˀyó:tsaˀ	‘a chin’	[o-ˀyó:ts-aˀ]	it.o-chin-noun.stem.former
ohnáˀtsaˀ	‘a bare butt’	[o-hnáˀts-aˀ]	it.o-buttock-noun.stem.former
aknǫ́hsaˀ	‘my house'	[aknǫ́hsaˀ]	I.o-house-noun.stem.former
ǫknínǫ̲hsaˀ	‘our house (two people)'	[ǫknínǫ̲hsaˀ]	we(two).o-house-noun.stem.former
ǫgwánǫ̲hsaˀ	‘our house (more than two people)'	[ǫgwánǫ̲hsaˀ]	we(all).o-house-noun.stem.former
sanǫ́hsaˀ	‘your house (one person)'	[sanǫ́hsaˀ]	you(one).o-house-noun.stem.former
sninǫ́hsaˀ	‘your house (two people)'	[sninǫ́hsaˀ]	you(two).o-house-noun.stem.former
swanǫ́hsaˀ	‘your house (more than two people)'	[swanǫ́hsaˀ]	you(all).o-house-noun.stem.former
honǫ́hsaˀ	‘his house'	[honǫ́hsaˀ]	he.o-house-noun.stem.former
gonǫ́hsaˀ	‘her house'	[gonǫ́hsaˀ]	she/someone.o-house-noun.stem.former
onǫ́hsaˀ	‘its house'	[onǫ́hsaˀ]	it.o-house-noun.stem.former
hodínǫ̲hsaˀ	‘their (males') house'	[hodínǫ̲hsaˀ]	they(males).o-house-noun.stem.former
godínǫ̲hsaˀ	‘their (females') house'	[godínǫ̲hsaˀ]	they(fe/males).o-house-noun.stem.former
knętsáˀgeh	‘on my arm’	[k-nęts-áˀgeh]	I.a-arm-on
hanę́tsa̲ˀgeh	‘on his arm'	[ha-nę́t-sa̲ˀgeh]	he.a-arm-on
enę́tsa̲ˀgeh	‘on her arm'	[e-nę́ts-a̲ˀgeh]	she/someone.a-arm-on
ganę́tsa̲ˀgeh	‘on its arm'	[ga-nę́ts-a̲ˀgeh]	it.a-arm-on
snętsáˀgeh	' on your arm (one person)'	[s-nęts-áˀgeh]	you(one).a-arm-on
sninę́tsa̲ˀgeh	'on your arm (two people)'	[sni-nę́ts-a̲ˀgeh]	you(two).a-arm-on
swanę́tsa̲ˀgeh	'on your arm (more than two people)'	[swa-nę́ts-a̲ˀgeh]	you(all).a-arm-on
hadinętsáˀgeh	'on their arm (males only)'	[hadi-nęts-áˀgeh]	they(males).a-arm-on
gaenętsáˀgeh	'on their arm (females or mixed)'	[gae-nęts-áˀgeh]	they(fe/males).a-arm-on
agénętsaˀ	‘my arm’	[agé-nęts-aˀ]	I.o-arm-noun.stem.former
ǫgyáˀse:ˀ	‘my cousin’	[ǫgy-áˀse:ˀ]	we.two-doubled.stative—[O-aˀse:ˀ]
degaǫdęhnǫ́:de:ˀ	‘his/her sister/brother’	[de-gaǫ-dę-hnǫ́:de:ˀ]	dualic-they(f/m)-semireflexive-sibling
de̱hęnadęhnǫ́:de:ˀ	‘his brother’	[de̱-hęn-adę-hnǫ́:de:ˀ]	dualic-they(males)-semireflexive-sibling
de̱hęnadęhnǫ́:drǫˀ	‘his brothers’	[de̱-hęn-adę-hnǫ́:dr-ǫˀ]	dualic-they(males)-semireflexive-sibling-distributive
degaeihwawáˀkǫˀ	‘her husband’, ‘his wife’	[de-gae-ihwawáˀkǫˀ]	dualic-they(f/m)-support.distributive
desni:hwáwaˀkǫˀ	‘your wife/husband’	[de-sni:-hwáwaˀkǫˀ]	dualic-you(two).a-support.distributive
deyakni:hwawáˀkǫ:ˀ	‘my wife/husband’	[de-yakni:-hwawáˀkǫ:ˀ]	dualic-we.two.exclusive-support.distributive
agya:dę́:nǫhk	‘my relative’	[agy-a:dę́:-ǫhk]	we.two.exclusive-semireflexive-related.stative
ǫgya:dę́:nǫhk	‘my relative’	[ǫgy-a:dę́:-nǫhk]	we.two.inclusive-semireflexive-related.stative
ǫgwa:dę́:nǫhk	‘our relative’	[ǫgwa:-dę́:-nǫhk]	we.all.inclusive-semireflexive-related.stative
ǫgwadęnǫhksǫˀ	‘our relatives’	[ǫgwa-dę-nǫhksǫˀ]	we.all.inclusive-semireflexive-related.stative.pluralizer
ja:dę́:nǫhk	‘your relative’	[j-a:dę́:-nǫhk]	you(two).a-semireflexive-related.stative
tgaegówanęˀs	‘my older siblings’	[t-gae-gówanęˀs]	cislocative-they(f/m)-big.stative.pluralizer
gaǫdriyáhsǫˀ	‘my older siblings’	[gaǫ-d-riyáhsǫˀ]	they(f/m)-semireflexive-older.sibling.stative
deyagwanǫhsakáhǫh	‘my neighbours’	[de-yagwa-nǫhsa-káhǫh]	dualic-we.all.exclusive-house-adjoin.stative
deyagyanǫhsané:gę:	‘my neighbour’	[de-yagya-nǫhs-a-né:gę:]	dualic-we.two.exclusive-house-joinerA-side.by.side.stative
ǫgya:dáoˀ	‘my ceremonial friend’	[ǫgya:-d-áoˀ]	we.two-semireflexive-run.stative
hona:dáoˀ	‘his ceremonial friend’	[hon-a:d-áoˀ]	they(males)-semireflexive-run.stative
ǫgwadáoˀsǫˀ	‘all of our ceremonial friends’	[ǫgwa-d-áoˀ-sǫˀ]	we.all-semireflexive-run.stative-pluralizer
ǫgyáˀse:ˀ	‘my cousin’	[ǫgy-áˀse:ˀ]	we.two-doubled.stative
honáˀse:ˀ	‘his cousin’	[hon-áˀse:ˀ]	they(males)-doubled.stative
ǫgwaˀse:ˀsǫ́:ˀah	‘all of my cousins’	[ǫgwa-ˀse:ˀ-sǫ́:-ˀah]	we.all-doubled.stative-pluralizer-diminutive
ǫgyá:tsih	‘my friend’	[ǫgy-á:tsih]	we.two-paired.stative
honá:tsih	‘his friend’	[hon-á:tsih]	they(males)-paired.stative
ǫgwátsi̲hsǫˀ	‘all of our friends’	[ǫgw-átsi̲h-sǫˀ]	we.all-paired.stative-pluralizer
ǫgyá:gyoh	‘my brother-in-law, sister-in-law’	[ǫgy-á:g-yoh]	we.two-sibling.in.law
honá:gyoh	‘her/his brother-in-law’	[hon-á:g-yoh]	they(males)-sibling.in.law
deyago̱hsnyéˀǫh	‘her adopted daughter’	[de-yago̱-hsnyéˀǫh]	dualic-her-cared.for.stative
akwa:jí:yaˀ	‘my family’	[ak-hwa:jí:y-aˀ]	my-family-noun.stem.former
agǫ́gwe̲ˀdaˀ	‘my relatives’	[ag-ǫ́gwe̲ˀd-aˀ]	my-people-noun.stem.former
ageksaˀgówa̲hsraˀ	‘my boyfriend or girlfriend’	[age-ksaˀgówa̲hsr-aˀ]	my-beautiful.one-noun.stem.former
hoksaˀgohwáhsraˀ	‘his girlfriend’	[ho-ksaˀgohwáhsr-aˀ]	his-beautiful.one-noun.stem.former
goksaˀgowáhsraˀ	‘her boyfriend’	[go-ksaˀgowáhsr-aˀ]	her-beautiful.one-noun.stem.former
henǫ́hweˀs	‘I like him’	[he-nǫ́hweˀs]	I:him-like.habitual
hehswáˀne:t	‘I support or back him’	[he-hswáˀn-e:t]	I:him-back-stand.stative
heksaˀgowáhsraˀ	‘my boyfriend’	[he-ksaˀgowáhsr-aˀ]	I:him-beautiful.one-noun.stem.former
keksaˀgowáhsraˀ	‘my girlfriend’	[ke-ksaˀgowáhsr-aˀ]	I:her-beautiful.one-noun.stem.former
kenǫ́hksǫˀ	‘my relatives’	[ke-nǫ́hksǫˀ]	I:her-related.pluralizer
ǫgyáˀse:ˀ	‘my cousin’	[ǫgy-áˀse:ˀ]	we.two-doubled.stative—[O-aˀse:ˀ]
heyá:dreˀ	‘my grandson’	[hey-á:dreˀ ]	I:him-grandchild
hagá:dreˀ	‘his grandson, me’; ‘I am his grandson’	[hag-á:dreˀ]	he:me-grandchild
keyá:dreˀ	‘my granddaughter’	[key-á:dreˀ]	I:her-grandchild
hǫwá:dreˀ	‘his/her grandson’	[hǫwá:-dreˀ]	s/he:him-grandchild
sheyá:dreˀ	‘your granddaughter’	[shey-á:dreˀ]	you.singular:her-grandchild
ǫdádadreˀ	‘her granddaughter’	[ǫdád-adreˀ]	she:her-grandchild
shagó:dreˀ	‘his granddaughter’	[shagó:-dreˀ]	he:her/them-grandchild
gaǫdadreˀsǫ́:ˀah	‘her grandchildren’	[gaǫd-adreˀsǫ́:ˀah]	theyf/m:themf/m-grandchild
shagódre̲ˀsǫˀ	‘his grandchildren’	[shagó-dre̲ˀsǫˀ]	he:her/them-grandchild
gakeyadréˀsǫˀ	‘my grandchildren’	[gakey-adréˀsǫˀ]	I:them-grandchild
gasheyadréˀsǫˀ	‘your grandchildren’	[gashey-adréˀsǫˀ]	you.singular:them-grandchild
hehsá:dreˀ	‘your grandson’	[hehs-á:dreˀ]	you.singular:him-grandchild
gwadre:ˀ	‘you are my grandchild’	[gw-adreˀ]	I:you(all)-grandchild
heˀgę́:ˀęh	'my younger brother'	[he-ˀgę́:ˀęh]	I:him-younger.sibling
hesheˀgę́:ˀęh	'your younger brother'	[heshe-ˀgę́:ˀęh]	you:him-younger.sibling
kheˀgę́:ˀęh	'my younger sister'	[khe-ˀgę́:ˀęh]	I:her-younger.sibling
ǫdade̲ˀgę́:ˀęh	'her younger sister'	[ǫdade̲-ˀgę́:ˀęh]	she:her-younger.sibling
shagoˀgę́:ˀęh	'his younger sister'	[shago-ˀgę́:ˀęh]	he:her/them-younger.sibling
hǫwaˀgę́:ˀęh	'his/her younger brother'	[hǫwa-ˀgę́:ˀęh]	s/he:him-younger.sibling
sheˀgę́:ˀęh	'your younger sister'	[she-ˀgę́:ˀęh]	you:her-younger.sibling
etiˀgę́:ˀah	‘our younger sister'	[eti-ˀgę́:ˀah]	we:her-younger.sibling
shǫgwaˀgę́:ˀah	‘our younger brother'	[shǫgwa-ˀgę́:ˀah]	we.all:him-younger.sibling
hehá:wahk	‘my son’	[he-há:wahk]	I:him-child
kehá:wahk	‘my daughter’	[ke-há:wahk]	I:her-child
ǫdatawá:kˀah	‘her maternal niece’	[ǫdat-hawá:kˀah]	she:her-niece
kehawá:kˀah	‘my maternal niece’	[ke-hawá:kˀah]	I:her-niece
gakeyǫ̲hwá:dęˀ	‘my brother's children’; ‘my nieces and nephews’	[gakey-ǫ̲hwá:dęˀ]	I/we.two:them-niece/nephew
keyǫhwá:dęˀ	‘my niece’	[key-ǫhwá:dęˀ]	I:her-niece/nephew
gasheyǫ̱hwádę̲ˀsǫˀ	‘your nieces and nephews’	[gashey-ǫ̱hwádę̲ˀsǫˀ]	you.singular:them-niece/nephew
gakeya̲ˀdá:węh	‘my brother's children’	[gake-ya̲ˀdá:węh]	I/we.two:them-niece/nephew
heyáˀdawęh	‘my nephew’	[he-yáˀdawęh]	I:him-supported.one
keyáˀdawęh	‘my brother's kids’	[ke-yáˀdawęh]	I:her-supported.one
hehshéhjiˀah	‘your older brother'	[hehshé-hjiˀah]	you:him-older.sibling
kehjíˀah	‘my older sister'	[ke-hjíˀah]	I:her-older.sibling
hakso:t	‘my grandfather’	[hagé-hso:t, hak-hso:t ]	he:me-grand.parent
hǫwáhso:t	‘his/her grandfather’	[hǫwá-hso:t]	she/he:him-grand.parent
ǫkíno̲haˀ	‘our mother’	[ǫkí-no̲haˀ]	she/they:us-mother
ǫkino̲há:ˀah	‘our (plural) aunt’	[ǫki-no̲há:ˀah]	she/they:us-aunt
hǫwáno̲ˀsęh	‘his/her uncle’	[hǫwá-no̲ˀsęh]	s/he:him-uncle
hyanóˀsęh	‘your (sg) uncle’	[hya-nóˀsęh]	he:you-uncle
shǫkníno̲ˀsęh	‘our (du) uncle’	[shǫkní-no̲ˀsęh]	he:us.two-uncle
hǫwáˀnih	‘his/her father’	[hǫwá-ˀnih]	s/he:him-father
hya̲ˀnih	‘your father’	[hya̲-ˀnih]	he:you-father
hǫwaˀní:hah	‘her godfather/step-father’	[hǫwa-ˀní:hah]	s/he:him-step.father
hakno:ˀ	‘my step-father’	[hak-no:ˀ]	he:me-step.parent/child
hehsno:ˀ	‘your step-son’	[hehs-no:ˀ]	you:him-step.parent/child
shé:no:ˀ	‘your step-daughter’	[shé:-no:ˀ]	you:her-step.parent/child
ǫkino̲há:ˀah	‘our (plural) aunt’	[ǫki-no̲há:ˀah]	she/they:us-aunt
shǫkníno̲ˀsęh	‘our (dual) uncle’	[shǫkní-no̲ˀsęh]	he:us.two-uncle
hené:nhǫ:s	‘my son-in-law’	[he-né:nhǫ:s]	I:him-in.law
hakné:nhǫ:s	‘my father-in-law’	[hak-né:nhǫ:s]	he:me-in.law
hyané:nhǫ:s	‘your father-in-law’	[hya-né:nhǫ:s]	he:you-in.law
hǫwánenhǫ:s	‘his/her father-in-law, son-in-law’	[hǫwá-nenhǫ:s]	s/he:him-in.law
shagónenhǫ:s	‘his mother-in-law’	[shagó-nenhǫ:s]	he:her/them-in.law
ǫdade̲hsé:yǫh	‘her mother-in-law’	[ǫdade̲-hsé:yǫh]	she:her-in.law
hohjíˀah	‘his older sister’	[ho-hjíˀah]	he.o-older.sibling
hehshéhjiˀah	‘your older brother’	[hehshé-hjiˀah]	you:him-older.sibling
hohso:t	‘his Grandma’	[ho-hso:t]	he.o-grand.parent
sa̱hso:t	‘your Grandmother’	[sa̱-hso:t]	you(one).o-grand.parent
hakso:t	‘my grandfather’	[hagé-hso:t] [hak-hso:t]	he:me-grand.parent
sano:ˀ	‘your step-mother’	[sa-no:ˀ]	you(one).o-step.parent/child
hono:ˀ	‘his step-mother’	[ho-no:ˀ]	he.o-step.parent/child
hakno:ˀ	‘my step-father’	[hak-no:ˀ]	he:me-step.parent/child
honó:haˀ	‘his mother’	[ho-nó:haˀ]	he.o-mother
sanó:haˀ	‘your mother’	[sa-nó:haˀ]	you(one).o-mother
ǫkíno̲haˀ	‘our mother’	[ǫkí-no̲haˀ]	she/they:us-mother
gono:há:ˀah	‘her aunt’	[go-no:há:ˀah]	she.o-aunt
sano:há:ˀah	‘your aunt’	[sa-no:há:ˀah]	you(one).o-aunt
ǫkino̲há:ˀah	‘our (plural) aunt’	[ǫki-no̲há:ˀah]	she/they:us-aunt
aknáˀehs	‘I have a step-mother’	[ak-náˀehs]	I.o-step.mother
sanáˀehs	‘your step-mother’	[sa-náˀehs]	you(one).o-step.mother
ǫknáˀehs	‘my step-mother’	[ǫk-náˀehs]	she:me-step.mother
sadęni̲hó:nǫˀ	‘your relatives on your (s) father's side’	[s-adę-ni̲-hó:nǫˀ]	you.semireflexive-father-populative
ǫkíno̲haˀ	‘our mother’	[ǫkí-no̲haˀ]	she/they:us-mother
hǫwáno̲ˀsęh	‘his/her uncle’	[hǫwá-no̲ˀsęh]	s/he:him-uncle
hǫwáˀnih	‘his/her father’	[hǫwá-ˀnih]	s/he:him-father
hǫwaˀní:hah	‘her godfather/step-father’	[hǫwa-ˀní:hah]	s/he:him-step.father
hakso:t	‘my grandfather’	[hagé-hso:t] [hak-hso:t]	he:me-grand.parent
hehso:t	‘Grandpa!’	[he-hso:t]	I:him-grand.parent
sewáihǫh	‘you are good at something’	[se-wáihǫh]	you(one).a-good.at.something.stative
agáhshę:	‘I am slow to act’	[ag-áhshę:]	I.o-slow.moving.stative
shaˀdá:tęhs	‘you are thirsty’	[s-haˀd-á:-tęhs]	you(one).a-throat-joinerA-dried.out.habitual
go̲haˀdí:yo:	‘she is a good singer’, ‘she has a good voice’	[go̲-haˀd-í:yo:]	she.o-throat-good.stative
hǫgweˀdí:yo:	‘he is a charming or nice person’	[h-ǫgweˀd-í:yo:]	he.a-person-good.stative
agǫgwe̲ˀdáhetgęˀ	‘she is a cruel, mean person’	[ag-ǫgwe̲ˀd-á-hetgęˀ]	she.o-person-ugly.stative
gashá:sdeˀ	‘it is strong’	[ga-shá:sdeˀ]	it.a-strong.stative
ganǫ:ˀ	‘it is expensive, dear, precious’	[ga-nǫ:ˀ]	it.a-costly.stative
ga̲hǫ́ˀji:	‘it is dark-coloured’	[ga̲-hǫ́ˀji:]	it.a-dark.coloured.stative
wagyé:sęh	‘it is easy’	[w-ag-yé:s-ęh]	it.a-semireflexive-easy-stative
ohní:yǫh	‘it is hard’	[o-hní:yǫh]	it.o-hard.stative
ogáhdeh	‘it is raw’	[o-gáhdeh]	it.o-raw.stative
onáˀno:ˀ	‘it is cold, cool’	[o-náˀno:ˀ]	it.o-cold.stative
ga̲hné:ga:t	‘it is watery'	[ga̲-hné:g-a:-t]	it.a-water-joinerA-stand.stative
wa̲hsóhǫ:t	‘it is dyed'	[w-a̲hsóh-ǫ:t ]	it.a-dye-attached.stative
gadręnagáˀǫh	‘it smells good, sweet, appetizing'	[ga-dręn-a-gáˀǫh]	it.a-smell-joinerA-good.tasting.stative
gahsdaowá:nęh	‘it is raining hard’	[ga-hsda:-owá:nęh]	it.a-rain-big.stative
ohneganá:wę:	‘lead, lukewarm water’	[o-hneg-a-ná:wę:]	it.o-water-joinerA-wet.stative
oihwí:yo:	‘it is for certain, sure'	[o-ihw-í:yo:]	it.o-matter-good.stative
degáhǫˀ	‘something is lying across a path, a door, etc.’	[de-gá-hǫˀ]	dualic-it.a-lie.across.stative
gá:yęˀ	‘it is lying on the ground’	[gá:-yęˀ]	it.a-lie.stative
gadę́hda:ˀ	‘it is lying spread out on the floor or the ground’	[ga-dę́hda:ˀ]	it.a-spread.out.on.ground.stative
gagéhǫˀ	‘things are lying about, around’	[ga-géhǫˀ]	it.a-lie.about.stative
áǫt	‘it is attached’; ‘it is sticking out’	[á-ǫt]	it.o-stick.out.stative
odáhǫh	‘it is draped’	[o-dáhǫh]	it.o-draped.stative
oˀdáihę:	‘it is hot’	[o-ˀdáih-ę:]	it.o-hot-stative
ga̲hsǫwa̲hdadáihę:	‘hot plate’	[ga̲-hsǫwa̲hd-a-dáih-ę:]	it.a-wire-joinerA-hot-stative
ga̲hsǫ́wa̲hdaˀ	‘wire, needle, nails’	[ga̲-hsǫ́wa̲hd-aˀ]	it.a-wire-nsf
ohnegadáihę:	‘hot water’	[o-hneg-a-dáih-ę:]	it.o-water-joinerA-hot-stative
ohnéganohs	‘water’	[o-hnég-a-nohs]	it.o-water-joinerA-cold.stative
ga̲hǫhsrowá:nęh	‘big box’	[ga̲-hǫhsr-owá:n-ęh]	it.a-box-big-stative
gahǫ́hsraˀ	‘a box’	[ga-hǫ́hsr-aˀ ]	it.a-box-nsf
ojǫˀdowá:nęh	‘big fish’	[o-jǫˀd-owá:n-ęh]	it.o-fish-big-stative
ojǫ́ˀdaˀ	‘a fish’	[o-jǫ́ˀd-aˀ]	it.o-fish-nsf
ganǫ:ˀ	‘it is expensive, dear, precious’	[ga-nǫ:ˀ]	it.a-costly.stative
ga̲hwíhsdanǫ:ˀ	‘gold’; ‘anything expensive’	[ga̲-hwíhsd-a-nǫ:ˀ]	it.a-metal-joinerA-costly.stative
ohwíhsdaˀ	‘money, metal’	[o-hwíhsd-aˀ]	it.o-metal-nsf
gahshá:sdeˀ	‘it is strong’	[ga-hshá:sdeˀ]	it.a-strong.stative
gawa:shá:sdeˀ	‘strong wind’	[ga-wa:-shá:sdeˀ]	it.a-air-strong.stative
ó:wa:ˀ	‘wind, air’	[ó:-wa:-ˀ]	it.o-air-nsf
gagéhǫˀ	‘things are lying about’	[ga-géhǫˀ]	it.a-lie.about.stative
gawidragéhǫˀ	‘ice scattered’	[ga-widr-a-géhǫˀ]	it.a-ice-joinerA-lie.about.stative
owí:draˀ	‘ice’	[o-wí:dr-aˀ]	it.o-ice-nsf
í:ga:ˀ	‘it contains’	[í:-ga-:ˀ]	partitive-it.a-contain.stative
ga̲hna:ˀ	‘how much gas is in there’	[do:] how [niyǫ́:] a certain amount [ga̲-hn-a-:ˀ]	it.a-oil-joinerA-contain.stative
ohnaˀ	‘oil, grease’	[o-hn-aˀ]	it.o-oil-nsf
ganí:yǫ:t	‘it is hanging’	[ga-ní:yǫ:t]	it.a-hang.stative
gayęhsraní:yǫ:t	‘a hanging blanket’	[ga-yęhsr-a-ní:yǫ:t]	it.a-blanket-joinerA-hang.stative
oyę́hsraˀ	‘a blanket’	[o-yę́hsr-aˀ]	it.o-blanket-nsf
gayahkwaní:yǫ:t	‘hanging pants’	[ga-yahkw-a-ní:yǫ:t]	it.a-pants-joinerA-hang.stative
oyáhkwaˀ	‘pants’	[o-yáhkw-aˀ]	it.o-pants-nsf
adę́hęˀ	‘a fence’	[ø-adę́hę-ˀ]	ø.prefix-gate-noun.stem.former
wadíhǫh	‘it is leaning’	[w-adíh-ǫh]	it.a-lean-stative
ga̲hǫwadíhǫh	‘a leaning boat’	[ga̲-hǫw-adíh-ǫh]	it.a-boat-lean-stative
ga̲hǫ́:waˀ	‘a boat’	[ga̲-hǫ́:w-aˀ]	it.a-boat-nsf
ohahaˀdíhǫh	‘the Milky Way’	[o-hah-adíh-ǫh]	it.o-road-lean-stative
oháhaˀ	‘road’	[o-háh-aˀ]	it.o-road-nsf
gyotsaditgę́ˀǫh	‘steam coming out’	[g-yo-t-hsad-itgę́ˀ-ǫh]	cislocative-it.o-semireflexive-fog-issue.forth-stative
gawęnitgę́ˀǫ:ˀ	‘a speech’	[ga-węn-itgę́ˀǫ-:ˀ]	it.a-word-issue.forth-nominalizer
áǫt	‘it is attached’; ‘it is sticking out’	[á-ǫt]	it.o-stick.out.stative
węˀníhsgaǫt	‘an attached wheel’	[w-ęˀníhsg-a-ǫt]	it.a-wheel-joinerA-stick.out.stative
ohsgyę́ˀdǫ:t	‘bone’	[o-hsgyę́ˀd-ǫ:t]	it.o-bone-stick.out.stative
gá:hǫh	‘it is covered’	[gá-:hǫh]	it.a-covered.stative
onyęˀgwáohǫh	‘drifted snow’	[o-nyęˀgw-á-ohǫh]	it.o-drifted.snow-joinerA-covered.stative
nitgá:deˀ	‘how high it is’ (inanimate object); ‘the height of something’	[ni-t-gá:-deˀ]	partitive-cislocative-it.a-exist.stative
ohá:deˀ	‘an existing road’	[o-há:-deˀ]	it.o-road-exist.stative
gadę́hda:ˀ	‘it is lying spread out on the floor or the ground’	[ga-dę́hda:ˀ]	it.a-lie.spread.out.stative
ganehsdá:dę̲hda:ˀ	‘a floor’	[ga-nehsdá:-dę̲hda:ˀ]	it.a-board-lie.spread.out.stative
owidradę́hda:ˀ	‘ice patch’	[o-widr-a-dę́hda:ˀ]	it.o-ice-lie.spread.out.stative
ga̲he:ˀ	‘it is sitting up on top of something’; ‘it is sitting here ’	[ga̲-he:ˀ]	it.a-sit.up.on.top.stative
ganáˀja̲he:ˀ	‘pail setting on something’	[ga-náˀj-a̲-he:ˀ]	it.a-pail-joinerA-sit.up.on.top.stative
ohsgę́ˀdra̲he:ˀ	‘it is rusting, rusty’	[o-hsgę́ˀdr-a̲-he:ˀ]	it.o-rust-joinerA-sit.up.on.top.stative
gá:yęˀ	‘it is lying on the ground’	[gá:-yęˀ]	it.a-lie.on.ground.stative
ganǫ́ˀaęˀ	‘a head lying on the ground’	[ga-nǫ́ˀa:-ęˀ]	it.a-head-lie.on.ground.stative
ohǫ́daęˀ	‘a bush, shrub’	[o-hǫ́d-a-ęˀ]	it.o-sapling-joinerA-lie.on.ground.stative
wadíhǫh	‘it is leaning against something’	[w-adíh-ǫh]	it.a-lean-stative
ga̲hǫwadíhǫh	‘a leaning boat’	[ga̲-hǫw-adíh-ǫh]	it.a-boat-lean-stative
ohahadíhǫh	‘the Milky Way’	[o-hah-adíh-ǫh]	it.o-road-lean-stative
degáhǫˀ	‘something is lying across a path, a door, etc.’	[de-gá-hǫˀ]	dualic-it.a-lie.across.stative
odóˀda̲hǫˀ	‘little waves’	[o-dóˀd-a̲-hǫˀ]	it.o-wave-joinerA-lie.across.stative
sgahsakáhǫ:ˀ	‘large mouth bass’	[s-ga-hs-a-káhǫ-:ˀ]	repetitive-it.a-mouth-joinerA-adjoin.stative-nominalizer
ohyákahǫˀ	‘tomatoes’	[o-hy-á-kahǫˀ]	it.o-berry-joinerA-adjoin.stative
gahnyo:t	‘it is standing’	[ga-hny-o:t]	it.a-stick-stand.stative
ga̲há:do:t	‘forest’	[ga̲-há:d-o:t]	it.a-forest-stand.stative
odrǫ́hyo:t	‘sunbeam, ray of light, sunshine’	[o-drǫ́hy-o:t]	it.o-beam.of.light-stand.stative
ojihsǫ́:da:ˀ	‘a cluster of stars, a star’	[o-jihsǫ́:da:-ˀ]	it.o-star-nsf
nigyowáęhę:	‘the direction of the wind’	[ni-g-yo-wá:-ęhę:]	partitive-cislocative-it.o-wind-direction.of.stative
ó:wa:ˀ	‘air, wind, a moth’	[ó:-wa:-ˀ]	it.o-air-nsf
heyohnegę́hę:ˀ	‘downstream’	[he-yo-hneg-ę́hę:ˀ]	translocative-it.o-water-direction.of.stative
ohnéga̲ˀgeh	‘on the water’	[o-hnég-a̲ˀgeh]	it.o-water-on
oˀnéhsaiˀ	‘it is sandy’	[o-ˀnéhs-a-iˀ]	it.o-sand-joinerA-stuck.to.stative
oˀnéhsaˀ	‘sand’	[o-ˀnéhs-aˀ]	it.o-sand-nsf
ohéhdaiˀ	‘earth is stuck to it’	[o-héhd-a-iˀ]	it.o-earth-joinerA-stuck.to.stative
ohéhdaˀ	‘dirt, earth, ground, land’	[o-héhd-aˀ]	it.o-earth-nsf
oihwagę́hya:t	‘it is almost to the end’	[o-ihw-a-gę́hya:t]	it.o-matter-joinerA-edge.of.stative
oíhwaˀ	‘message’; ‘it matters’; ‘it is its fault’; ‘word, affair, business’	[o-íhw-aˀ]	it.o-matter-nsf
ohnegagę́hya:t	‘just above the water’	[o-hneg-a-gę́hya:t]	it.o-water-joinerA-edge.of.stative
ohnéga̲ˀgeh	‘on the water’	[o-hnég-a̲ˀgeh]	it.o-water-on
degaiˀę́ho:t	‘it is piled up’	[de-ga-iˀę́h-o:t]	dualic-it.a-pile-stand.stative
ga̲hsdęhó:dǫˀ	‘mountains, pile of boulders’	[ga̲-hsdęh-ó:d-ǫˀ]	it.a-rock-stand.stative-pluralizer
sganáˀja:t	‘one bottle’	[s-ga-náˀj-a:-t]	repetitive-it.a-drum-joinerA-stand.stative
ganáˀja:t	‘a standing bottle’	[ga-náˀj-a:-t]	it.a-drum-joinerA-stand.stative
niyohǫnáˀdage:	‘three potatoes’	[ahsę́h] three [ni-yo-hǫnáˀd-age:]	partitive-it.o-potato-two.or.more.stative
nigahǫnáˀdage:	‘three potatoes’	[ahsę́h] three [ni-ga-hǫnáˀd-age:]	partitive-it.a-potato-two.or.more.stative
ohǫ́na̲ˀdaˀ	‘potatoes’	[o-hǫ́na̲ˀd-aˀ]	it.o-potato-nsf
sgayę́hsra:t	‘one blanket’	[s-ga-yę́hsr-a:-t]	repetitive-it.a-blanket-joinerA-stand.stative
joyę́hsra:t	‘one blanket’	[j-o-yę́hsr-a:-t]	repetitive-it.o-blanket-joinerA-stand.stative
oyę́hsraˀ	‘blanket’	[o-yę́hsr-aˀ]	it.o-blanket-nsf
sgahǫ́na̲ˀda:t	‘one potato’	[s-ga-hǫ́na̲ˀd-a:-t]	repetitive-it.a-potato-joinerA-stand.stative
jo̲hǫ́na̲ˀda:t	‘one potato’	[j-o̲-hǫ́na̲ˀd-a:-t ]	repetitive-it.o-potato-joinerA-stand.stative
ohǫ́na̲ˀdaˀ	‘potato’	[o-hǫ́na̲ˀd-aˀ]	it.o-potato-nsf
joháha:t	‘one road’	[j-o-háh-a:-t]	repetitive-it.o-road-joinerA-stand.stative
oháhaˀ	‘road’	[o-háh-aˀ]	it.o-road-nsf
sekséˀda̲ˀgeh	‘on your belly’	[s-e-kséˀd-a̲ˀgeh]	you(one).a-epen-belly-on
gikséˀdo:t	‘my navel, my belly button’	[g-ikséˀd+o:t]	I.a-belly-attached.stative
gatséˀdaˀ	‘a bottle’	[ga-itséˀd-aˀ] it.a-bottle-nsf [ga-tséˀd-aˀ]	it.a-bottle-nsf
otséˀdo:t	‘hubbard squash’	[o-tséˀd_o:t]	it.o-bottle-stand.stative
getséˀdo:t	‘my navel’	[g-e-tséˀd+o:t ]	I.a-epen-bottle-stand.stative
niwú:ˀuh	'it is small'	[niwú:ˀuh]	partitive-it.a-small.stative
nihahna̲ˀtsˀú:ˀuh	‘he has a small butt’	[ni-ha-hna̲ˀts-ú:ˀuh]	partitive-he.a-buttocks-small.stative
hahnáˀtsa̲ˀgeh	‘on his buttocks’	[ha-hnáˀts-a̲ˀgeh]	he.a-buttocks-on
[+es]	'long',	[í:yǫs] 'it is long' [í:-y-ǫs]	prothetic-it.o-long.stative
degénętse:s	‘my arms are long’; ‘I have two long arms’	[de-g-é-nęts-e:s]	dualic-I.a-joinerE-arm-long.stative
knętsáˀgeh	‘on my arm’	[k-nęts-áˀgeh]	I.a-arm-on
niwú:ˀuh	'it is small'	[niwú:ˀuh]	partitive-it.a-small.stative
nihohkyędahkú:ˀuh	‘his small chair’	[ni-ho-hkyędahk-ú:ˀuh]	partitive-he.o-chair-small.stative
akyę́da̲hkwaˀ	‘chair’	[akyę́da̲hkw-aˀ]	chair-nsf
[+es]	'long',	[í:yǫs] 'it is long' [í:-y-ǫs]	prothetic-it.o-long.stative
sanóˀje:s	‘your tooth is long’	[sa-nóˀj-e:s]	you(one).o-tooth-long.stative
onóˀjaˀ	‘tooth’	[o-nóˀj-aˀ]	it.o-tooth-nsf
snętso:t	‘you have an (attached) arm’	[s-nęts-o:t]	you(one).a-arm-stand.stative
snętsáˀgeh	‘on your arm’	[s-nęts-áˀgeh]	you(one).a-arm-on
hoˀdréhdaęˀ	‘he has a car, his car’	[ho-ˀdréhd-a-ęˀ]	he.o-car-joinerA-lie.stative
hó:yęˀ	‘he has, owns it’	[hó:-yęˀ]	he.o-lie.stative
ga̲ˀdréhdaˀ	‘car’	[ga̲-ˀdréhd-aˀ]	it.a-car-noun.stem.former
ogéˀa:ˀ	‘hair’; ‘a rag’	[o-géˀa:-ˀ]	it.o-hair-noun.stem.former
sanę́:tso:t	‘you have an arm’; ‘your attached arm’	[sa-nę́:ts-o:t]	you(one).o-arm-stand.stative
snętsáˀgeh	‘on your arm’	[s-nęts-áˀgeh]	you(one).a-arm-on
knoˀjo:t	‘I have teeth’	[k-noˀj-o:t]	I.a-tooth-stand.stative
kno̲ˀjáˀgeh	‘on my teeth’	[k-no̲ˀj-áˀgeh]	I.a-tooth-on
honáhsgwaęˀ	‘he has a pet’	[ho-náhsgw-a-ęˀ]	he.o-domestic.animal-joinerA-lie.stative
ganáhsgwaˀ	‘pet’; ‘domestic animal’	[ga-náhsgw-aˀ]	it.a-domestic.animal-noun.stem.former
ganóˀjaęˀ	‘it has teeth’	[ga-nóˀj-a-ęˀ]	it.a-teeth-joinerA-lie.stative
sagǫ́hsaęˀ	‘you have a face’	[sa-gǫ́hs-a-ęˀ]	you(one).o-face-joinerA-lie.stative
ehyagwiyó:dǫˀ	‘she is got toes’; ‘her toes’	[e-hyagwiy-ó:d-ǫˀ]	she.a-toe-stand.stative-pluralizer
godinǫhsáędǫˀ	‘they (females or mixed) have several houses’	[godi-nǫhs-á-ę-d-ǫˀ]	they(animals)/objects.o-house-joinerA-lie.stative-pronunciation.d-pluralizer
ganǫ́hsaˀ	‘house’	[ga-nǫ́hs-aˀ]	it.a-house-noun.stem.former
sehshaǫ:t	‘you are tied up’	[s-e-hsh-a-ǫ:t]	you(one).a-joinerE-string-stand.stative
odwę́:no:t	‘it is baying, howling’	[o-d-wę́:n-o:t]	it.o-semireflexive-voice-stand.stative
gonhę́ho:t	‘she pees all the time’	[go-nhę́h-o:t]	she.o-urine-stand.stative
ęhsęnadáęˀ	‘you will camp’	[ę-hs-ę-nad-á-ęˀ]	future-you(one).a-semireflexive-town-joinerA-lie.stative
degaǫwę́hda:s	'they (females or mixed group) run'	[de-gaǫ-wę́hda:d-s]	dualic-they(fe/males).a-run-habitual
da:gáǫwę̲hda:t	'they (females or mixed group) might run'	[d-a:-gáǫ-wę̲hda:t]	dualic-indefinite-they(fe/males).a-run-ø.punctual
dewagę̲hdá:dǫh	'I have run'	[de-wag-ę̲hdá:d-ǫh]	dualic-I.o-run-stative
de̲haihwágenhahs	‘he is a lawyer’	[de̲-ha-ihw-á-genh-a-hs]	dualic-he.a-matter-joinerA-advocate-joinerA-habitual
dęhsrihwagé:nhaˀ	‘you will argue, debate, protest’	[d-ę-hs-rihw-a-gé:nh-a-ˀ]	dualic-future-you(one).a-matter-joinerA-advocate-joinerA-punctual
deyagodihwágenhęh	‘they (f/m) are arguing’	[de-yagodi-ihw-á-genh-ęh]	dualic-they(fe/males).o-matter-joinerA-advocate-stative
gę:s	‘I used to sleep a lot’	[i:sóˀ] much [ag-ida̲-hs-gęhę́:ˀ ]	I.o-sleep-habitual-past
ęwa:gí:daˀ	‘I will sleep’	[ę-wa:g-í:da-ˀ]	future-I.o-sleep-punctual
ǫgí:daˀ	‘I slept’	[ǫg-í:da-ˀ]	I.o-sleep-punctual
agída̲ˀǫh	‘I amsleeping’	[ag-ída̲ˀ-ǫh]	I.o-sleep-stative
hoyǫ́:dih	‘he is smiling’	[ho-yǫ́:di-h]	he.o-smile-habitual
aho:yǫ́:diˀ	‘he smiled’	[a-ho:-yǫ́:di-ˀ]	factual-he.o-smile-punctual
agénya̲ˀgwahs	‘I vomit all the time’	[ag-é-nya̲ˀgw-a-hs]	I.o-joinerE-vomit-joinerA-habitual
ǫgénya̲ˀgoˀ	‘I vomited’	[ǫg-é-nya̲ˀgo-ˀ]	factual.I.o-joinerE-vomit-punctual
de̲hóhetaˀ	‘he is hollering’	[de̲-hó-het-haˀ]	dualic-he.o-yell-habitual
athóhe:t	‘he hollered or yelled’	[a-t-hó-he:t]	factual-dualic-he.o-yell-ø.punctual
ęhshǫ:gwá:yǫˀ	'he will give something to us all'	[ę-hshǫ:gwá:y-ǫ-ˀ]	future-he:us-give-punctual
shǫgwá:wi:	'he has given something to us all'	[shǫgw-á:wi-:]	he:us-give-stative
gá:gęh(s)	'it sees (it)'	[gá:-gę-hs]	it.a-see-habitual
ęgá:gęˀ	'it will see (it)'	[ę-gá:-gę-ˀ]	future-it.a-see-punctual
hehaihwę́hęhs	'he always takes the message’; ‘he is a messenger'	[he-ha-ihw-ę́hę-hs]	translocative-he.a-matter-convey-habitual
agé:gaˀs	‘I like the taste (of it)’	[ag-é:-gaˀ-s]	I.o-joinerE-like.the.taste.of-habitual
ęwa:gé:gaˀ	‘I will like the taste’	[ę-wa:g-é:-gaˀ]	future-I.o-joinerE-like.the.taste.of–ø.punctual
giˀ	‘I did like (it)!’	[ǫg-e:-gáˀ]	I.o-joinerE-like.the.taste.of.stative
agé:swahs	‘I smell (it) right now’	[ag-é:-sw-a-hs]	I.o-joinerE-smell-joinerA-habitual
ęwágeshoˀ	‘I’ll smell (it)’	[ę-wág-e-sho-ˀ]	future-I.o-joinerE-smell-punctual
ǫgé:shoˀ	‘I did smell (it)’	[ǫg-é:-sho-ˀ]	factual.I.o-joinerE-smell-punctual
ǫga:tǫ́:dęh	‘I heard (it)’	[ǫg-a:tǫ́:dęh]	I.o-hear-ø.punctual
agatǫdę́ˀǫh	‘I’ve heard (it) before’	[ag-atǫdę́ˀ-ǫh]	I.o-hear-stative
hehó:gyeˀs	‘it throws (it)’ (all the time); ‘he is a pitcher’	[he-hó:-gy-eˀs]	translocative-he.o-throw-habitual
haˀhó:diˀ	‘he threw (it)’	[haˀ-hó:-di-ˀ]	translocative-he.o-throw-punctual
hehó:gyǫ:	‘he has thrown (it)’	[he-hó:-gy-ǫ:]	translocative-he.o-throw-stative
hadó:wa:s	'he is a hunter'	[h-adó:wa:d-s]	he.a-hunt-habitual
hadowasgę́hę:ˀ	'he used to be a hunter'	[h-adowad-s-gę́hę:ˀ]	he.a-hunt-habitual-past
hadówa̲hstahk	'he used to be a hunter (long ago)'	[h-adówa̲hst-ha-hk]	he.a-hunt-habitual-former
hahdo:s	'he dives, he is a diver'	[h-ahdo:-s]	he.a-dive-habitual
hahdóhsgę̲hę:ˀ	'he used to dive'	[h-ahdó-hs-gę̲hę:ˀ]	he.a-dive-habitual-past
go̲hsóˀkaˀ	'she is limping'	[go̲-hsóˀk-haˀ]	she.o-limp-habitual
go̲hsóˀkahk	'she used to limp’	[go̲-hsóˀk-ha-hk]	she.o-limp-habitual-former
ęhsáhso̲ˀka:k	'you will limp'	[ę-hs-áhso̲ˀk-ha-:k]	future-you(one).o-limp-habitual-modalizer
agé:gaˀs	'I like the taste of it'	[ag-é:-gaˀ-s]	I.o-joinerE-like.the.taste.of-habitual
saníˀǫh	'you are stingy, greedy, cheap'	[sa-níˀ-ǫh]	you(one).o-cheap-stative
saníˀǫhne:ˀ	'you used to be stingy'	[sa-níˀ-ǫh-ne:ˀ]	you(one).o-cheap-stative-past
deyagodáwęnyeˀ	'she is walking about'	[de-yago-d-áwęnye-ˀ]	dualic-she.o-semireflexive-stir-stative
dęyagodawęnyéha:k	'she will be walking about'	[d-ę-yago-d-awęnyé-h-a-:k]	dualic-future-she.o-semireflexive-stir-pronunciation.h-joinerA-modalizer
hahę́:dǫ:	'he is the front, leader'	[ha-hę́:d-ǫ:]	he.a-lead-stative
hahę́dǫ̲hne:ˀ	'he used to be a leader'	[ha-hę́d-ǫ̲h-ne:ˀ]	he.a-lead-stative-past
degágwatwęh	'a hem'	[de-gá-gwatw-ęh]	dualic-it.a-hem-stative
dęgagwatwę́hę:k	'it will be hemmed'	[dę-ga-gwatw-ę́h-ę-:k]	future-it.a-hem-stative-joinerA-modalizer
itgeˀs	‘I amhere’	[i-t-g-e-ˀs]	prothetic-cislocative-I.a-go-habitual
haˀgeˀ	‘I amgoing there’	[haˀ-g-e-ˀ]	translocative.factual-I.a-go-punctual
haˀge:ˀ	‘I went there’	[haˀ-g-e-:-ˀ]	translocative.factual-I.a-go-purposive-punctual
í:geˀ	‘I am walking, moving’	[í:-g-e-ˀ]	prothetic-I.a-go-stative
há:ge:	‘where I might go’	[to] [h-á:-g-e-:]	translocative-indefinite-I.a-go-no.aspect
ge̲hsreˀ	‘I am chasing it’	[g-e̲-hsr-e-ˀ]	I.a-joinerE-chase-go-stative
agéˀdreˀ	‘I am riding along’	[ag-é-ˀdr-e-ˀ]	I.o-joinerE-drag-go-stative
dehęnatkwáhneˀ	'they (m) are going to dance'	[de-hęn-at-kw-á-hn-e-ˀ]	dualic-they(males).a-semireflexive-dance-joinerA-dislocative-go-stative
de̲hohedáhneˀ	'he is going along hollering'	[de̲-ho-hed-á-hn-e-ˀ]	dualic-he.o-yell-joinerA-dislocative-go-stative
de̲hóhethaˀ	'he is hollering'	[de̲-hó-het-haˀ]	dualic-he.o-yell-habitual
hǫwahnǫdr-á:gyeˀ	'someone is following him along'	[hǫwa-hnǫdr-á:-gy-e-ˀ]	they:him-follow-joinerA-progressive-go-stative
hǫwáhnǫdreˀ	'someone is following him'	[hǫwá-hnǫdr-e-ˀ]	they:him-follow-go-stative
gayę́tw-agyeˀ	'it is planted along'	[ga-yę́tw-a-gy-e-ˀ]	it.a-plant-joinerA-progressive-go-stative
gayę́:twęh	'it is planted'	[ga-yę́:tw-ęh]	it.a-plant-stative
ohsáw-agyeˀ	'it is beginning'	[o-hsáw-a-gy-e-ˀ]	it.o-begin-joinerA-progressive-go-stative
thohsa:ˀ	'he has begun'	[t-ho-hsa:-ˀ]	cislocative-he.o-begin-stative
sa̲hohdęhgyǫ́hǫgyeˀ	'he is on his way home'	[sa̲-ho-hdęhgy-ǫ́h-ǫ-gy-e-ˀ]	repetitive-he.o-leave-stative-joinerA-progressive-go-stative
hesáhdęgy-ǫ:	'you went over there'	[he-sá-hdęgy-ǫ:]	translocative-you(one).o-leave-stative
otsihsˀǫ̲hǫ́:gyeˀ	'it is getting mature'	[o-tsihsˀ-ǫ̲h-ǫ́:-gy-e-ˀ]	it.o-mature-stative-joinerA-progressive-go-stative
otsíhsˀ-ǫh	'it is done for the season', 'it has gone full cycle', 'it is mature', 'they (plants) have finished out'	[o-tsíhsˀ-ǫh]	it.o-mature-stative
ęhse:já:gǫ:ˀ	‘you will persevere’	[ę-hs-e:-já:gǫ-:ˀ]	future-you.singular-joinerE-persevere-punctual
sadeˀnyę́:dęh	‘(you) try it!’	[s-ade-ˀnyę́:dę-h]	you(one).a-semireflexive-try-no.aspect/pronunciation.h
ęhsade̲ˀnyę́:dęˀ	‘you will try it’	[ę-hs-ade̲-ˀnyę́:dę-ˀ]	future-you(one).a-semireflexive-try-punctual
desahdę́:dih.	‘(you) leave right away!’	[gǫdagyéˀ] right.away  [de-s-ahdę́:di-h]	dualic-you(one).a-leave-no.aspect/pronunciation.h
sadahǫ́:dǫ:	‘(you) ask!’	[s-ad-ahǫ́:dǫ:]	you(one).a-semireflexive-ask-no.aspect
ęsada̲hǫ́:dǫ:ˀ	‘you will ask’	[ę-s-ad-a̲hǫ́:dǫ:-ˀ]	future-you(one).a-semireflexive-ask-punctual
segá:nę:t	‘(you) lick it!’	[s-e-gá:nę:t]	you(one).a-joinerE-lick-no.aspect
ęhséganę:t	‘you will lick it’	[ę-hs-é-ganę:t]	future-you(one).a-joinerE-lick-ø.punctual
deyǫkni̲ˀdráihęh	‘let us two hurry’	[de-yǫkni̲-ˀdráihę-h]	dualic-we.two-hurry-no.aspect/pronunciation.h
etiyená:waˀs	‘let us all help her/them’	[eti-yená:waˀs]	we:her/them-help-no.aspect
dedwadagyénawaˀs	‘let us all help one another’	[de-dw-adag-yénawaˀs]	dualic-we.all-reflexive-help-no.aspect
a:gadeˀnyę́:dęˀ	‘I might try or attempt it’	[a:-g-ad-e-ˀnyę́:dę-ˀ]	indefinite-I.a-semireflexive-joinerE-try-punctual
count’;	‘let us all count’	[dw-a̲hshe:t]	we.all-count-no.aspect
dedwadagyénawahs	‘let us all help each other’	[de-dw-adag-yénawaˀs]	dualic-we.all-reflexive-help-no.aspect
ǫgyénawaˀs	‘Someone help me!’	[sǫga:ˀáh] someone [ǫg-yénawaˀs]	she:me-help.no.aspect
ęsada̲hǫ́:dǫ:ˀ	‘you will ask!’	[ę-s-ada̲hǫ́:dǫ:-ˀ]	future-you(one).a-ask-punctual
ętsahdę́:diˀ.	‘You will leave right away!’	[gǫdagyéˀ] right.away [ę-t-s-ahdę́:di-ˀ]	future-dualic-you(one).a-leave-punctual
ętsáhshe:t	‘You will count by ones’; ‘count one by one!’	[sgatsǫ́ˀ] one.by.one [ę-t-s-áhshe:t]	future-dualic-you(one).a-count.ø.punctual
a:yagwahsę́:nǫˀ	‘we all should give it a name’	[a:-yagwa-hsę́:n-ǫ-ˀ]	indefinite-we.all.exclusive.a-name-give-punctual
ǫ:dasáhsawęˀ	‘you should begin’	[ǫ:da-s-áhsawę-ˀ]	indefinite.cislocative-you(one).a-begin-punctual
ǫ:tahá:wiˀ	‘he should bring something’	[ǫ:t-ha-há:wi-ˀ]	indefinite.cislocative-he.a-carry-punctual
áeswa:k	‘you all should eat it’	[áe-swa:-k]	indefinite-you(all).a-eat.ø.punctual
ęhsa:tró:wih	‘do not tell anything’	[ahgwíh] do not [ę-hs-a:t-hró:wi-h]	future-you(one).a-semireflexive-tell-no.aspect/pronunciation.h
ędíhsa̲ˀdre:	‘do not drive over there’	[ahgwíh] do not [ę-dí-hsa̲-ˀdre:]	future-cislocative-you(one).o-drive.no.aspect
hęhsáˀdre:	‘do not drive over there’	[ahgwíh] do not [h-ę-hsá-ˀdre:]	translocative-future-you(one).o-drive.no.aspect
ęhsá:sdi:s	‘do not disturb it’; ‘do not handle it’	[ahgwíh] do not [ę-hs-á:sdi:s]	future-you(one).a-care.for.no.aspect
dęhsnigǫ̲háęˀ.	‘do not bother it’	[ahgwíh] do not [d-ę-hs-ˀnigǫ̲h-á-ęˀ]	dualic-future-you(one).a-mind-joinerA-lie.punctual
ęhsatwi̲hsdę́ˀda:ˀ	‘do not waste your money’	[ahgwíh] do not [ę-hs-at-hwi̲hsd-ę́ˀda:-ˀ]	future-you(one).a-semireflexive-money-burn.up-punctual
taeswá:gę:	‘you all shouldn't or won't see it’	[tęˀ] no [t-ae-swá:-gę:]	contrastive-indefinite-you(all).a-see.no.aspect
a:sejáodęˀ	‘No Smoking’	[tęˀ] not [t-a:-w-a:dǫ́-h] contrastive-indefinite-it.a-become-pronunciation.h [a:-s-e-j-á-odę-ˀ]	indefinite-you(one).a-joinerE-smoke-joinerA-put.in-punctual
ęwá:dǫˀ	‘Yes, you may’	[ę-w-á:dǫ-ˀ]	future-it.a-become-punctual
iheˀs	‘he is here’	[i-h-e-ˀs]	prothetic-he.a-go-habitual
tgiˀdrǫˀ	‘where I live’	[t-g-iˀdrǫˀ]	cislocative-I.a-dwell.stative
hadiˀdrǫ́:dǫˀ	‘how they are placed’	[had-iˀdrǫ́:-d-ǫˀ]	they-dwell-pronunciation.d-pluralizer
ęhsniˀdrǫ́:daˀk	‘you two will stay home’	[ę-hsn-iˀdrǫ́:-d-a-ˀk]	future-you(two).a-dwell-causative-joinerA-modalizer
tgáenagreˀ	‘where they (f/m) live over there’	[t-gáe-nagreˀ]	cislocative-they-dwell.stative
knagreˀ	‘I live, stay’	[k-nagreˀ]	I.a-dwell.stative
dwaknǫ́hso:t	‘where I dwell’	[shęh] that [d-wak-nǫhs-o:t]	cislocative-I.o-house-stand.stative
nigá:yęˀ	‘where it is at’; ‘where it is placed’	[ni-gá:-yęˀ]	partitive-it.a-lie.on.ground.stative
ohwę́jadeˀ	‘existing earth, land’	[o-hwę́j-a-deˀ]	it.o-land-joinerA-exist.stative
sganáˀja:t	‘one bottle’	[s-ga-náˀj-a:-t]	repetitive-it.a-drum-joinerA-stand.stative
ganáˀja:t	‘a standing bottle’	[ga-náˀj-a:-t]	it.a-drum-joinerA-stand.stative
sgayę́hsra:t	‘one blanket’	[s-ga-yę́hsr-a:-t]	repetitive-it.a-blanket-joinerA-stand.stative
oyę́hsraˀ	‘blanket’	[o-yę́hsr-aˀ]	it.o-blanket-nsf
sgaˀnhǫ́hsa:t	‘one egg’	[s-ga-ˀnhǫ́hs-a:-t]	repetitive-it.a-egg-joinerA-stand.stative
joˀnhǫ́hsa:t	‘one egg’	[j-o-ˀnhǫ́hs-a:-t]	repetitive-it.o-egg-joinerA-stand.stative
oˀnhǫ́hsaˀ	‘egg’	[o-ˀnhǫ́hs-aˀ]	it.o-egg-nsf
joháha:t	‘one road’	[j-o-háh-a:-t]	repetitive-it.o-road-joinerA-stand.stative
oháhaˀ	‘road’	[o-háh-aˀ]	it.o-road-nsf
swanaháotra:t	‘one hat’	[s-w-anaháotr-a:-t]	repetitive-it.a-hat-joinerA-stand.stative
anaháotraˀ	‘hat’	[anaháotr-aˀ]	ø.prefix-hat-nsf
sgahyádǫ̲hkwa:t	‘one pencil’	[s-ga-hyádǫ̲hkw-a:-t]	repetitive-it.a-pencil-joinerA-stand.stative
ehyádǫ̲hkwaˀ	‘pencil’	[e-hyádǫ̲-hkwaˀ]	someone-write-instrumental
degaji̲hsdá:ge:	‘two lamps’	[de-ga-ji̲hsd-á:ge:]	dualic-it.a-lamp-certain.number.stative
gajíhsdaˀ	‘lamp’	[ga-jíhsd-aˀ]	it.a-lamp-nsf
deyoˀnǫ̲hsá:ge:	‘two eggs’	[de-yo-ˀnǫ̲hs-á:ge:]	dualic-it.o-egg-be.a.certain.number.stative
oˀnhǫ́hsaˀ	‘egg’	[o-ˀnhǫ́hs-aˀ]	it.o-egg-nsf
deyohsi̲ˀdá:ge:	‘two feet’	[de-yo-hsi̲ˀd-á:ge:]	dualic-it.o-foot-be.a.certain.number.stative
ohsíˀdaˀ	‘foot’	[o-hsíˀd-aˀ]	it.o-foot-nsf
dewahda̲hgwá:ge:	‘two shoes’	[de-wa-hda̲hgw-á:ge:]	dualic-it.a-shoe-be.a.certain.number.stative
ahdáhgwaˀ	‘shoe’	[ahdáhgw-aˀ]	ø.prefix-shoe-nsf
niganǫ̲hsá:ge:	‘three houses’	[ni-ga-nǫ̲hs-á:ge:]	partitive-it.a-house-be.a.certain.number.stative
ganǫ́hsaˀ	‘house’	[ga-nǫ́hs-aˀ]	it.a-house-nsf
niyohsi̲ˀdá:ge:	‘three feet’	[ni-yo-hsi̲ˀd-á:ge:]	partitive-it.o-foot-be.a.certain.number.stative
ohsíˀdaˀ	‘feet’	[o-hsíˀd-aˀ]	it.o-foot-nsf
niyohǫnáˀdage:	‘three potatoes’	[ni-yo-hǫnáˀd-age:]	partitive-it.o-potato-be.a.certain.number.stative
nigahǫnáˀdage:	‘three potatoes’	[ni-ga-hǫnáˀd-age:]	partitive-it.a-potato-be.a.certain.number.stative
ohǫ́na̲ˀdaˀ	‘potatoes’	[o-hǫ́na̲ˀd-aˀ]	it.o-potato-nsf
niwahda̲hgwá:ge:	‘three shoes’	[ni-w-ahda̲hgw-á:ge:]	partitive-it.a-shoe-be.a.certain.number.stative
ahdáhgwaˀ	‘shoes’	[ahdáhgw-aˀ]	ø.prefix-shoe-nsf
ahdahgwáǫweh	‘one ceremonial shoe’	[s-wa̲-hdahgw-á:-t] repetitive-it.a-shoe-joinerA-stand.stative [ahdahgwá-ǫweh]	ø.prefix-shoe-typicalizer
dagus	‘one pet cat’	[s-ga-nahsgw-á:t]	repetitive-it.a-tame.animal-joinerA-stand.stative
ohó:draˀ	‘two basswood trees’	[de-grahe̲ˀd-a:gé:] dualic-tree-certain.number.stative [o-hó:dr-aˀ]	it.o-basswood-nsf
dagus	‘one cat’	[s-ga-yaˀd-á:-t]	repetitive-it.a-body-joinerA-stand.stative
dagus	‘two cats’	[de-gadi-yahshé:]	dualic-they(animals)/objects.a-two.living.things.stative
dagus	‘three cats’	[ahsę́h] three [ni-gę:n-ǫ́:]	partitive-they(animals)/objects.a-certain.number.stative
agǫgwe̲ˀdá:se:	‘one young woman’	[j-e-yaˀd-a:-t] repetitive-she.a-body-joinerA-stand.stative [ag-ǫgweˀd-a:se:]	she.a-person-new.stative
ga:gǫgwéˀdase:	‘two young women’	[de-gae-yahshé:]  dualic-they(fe/males).a-two.stative [ga:g-ǫgwéˀd-ase:]	they(fe/males).a-person-new.stative
ga:gǫgwéˀdase:	‘three young women’	[ahsę́h] ‘three’ [ni-ga:g-ǫ́:]  partitive-they(fe/males).a-certain.number.stative [ga:g-ǫgwéˀd-ase:]	they(fe/males).a-person-new.stative
haksá:ˀah	‘one boy’	[s-ha-yaˀd-á:t] repetitive-he.a-body-stand.stative [ha-ksá:ˀah]	he.a-young.child
hadiksá:ˀah	‘two boys’	[de̲-hadi-yahshé:] dualic-they(males)-two.living.things.stative [hadi-ksá:ˀah]	they(males)-young.child
hadiksa̲ˀsǫ́:ˀǫh	‘three boys’	[ahsę́h] ‘three’ [ni̲-hę:n-ǫ́:] partitive-they(males)-certain.number.stative [hadi-ksa̲ˀsǫ́:ˀǫh]	they(males)-young.child-pluralizer
oná:tsih	‘three pairs of socks’	[ahsęh] ‘three’ [ni:-y-ǫ́:]	partitive-it.o-be.a.number.of.things.stative
wadǫ:dá:taˀ]	‘four gallons’	[geí] four [ni:-y-ǫ́:]	partitive-it.o-be.a.number.of.things.stative,
wadǫ:dá:taˀ	‘one gallon’	[geí] four [ni-ga-itse̲ˀd-á:ge:] partitive-it.a-bottle-two.or.more.stative [w-ad-ǫ:dá:t-haˀ]	it.a-semireflexive-contain-habitual
shayę́dǫtaˀ	‘he put one more piece of wood on the fire’	[sga:t] one [s-ha-yę́d-ǫt-h-a-ˀ]	repetitive-he.a-firewood-place-dislocative-joinerA-punctual
oyę́:daˀ	‘firewood’	[o-yę́:d-aˀ]	it.o-firewood-nsf
•agęˀ	‘people say’, ‘it is said’	[ag-ęˀ]	factual.she/someone-say.punctual
•agá:węh	‘mine; I own it’	[ag-á:w-ęh]	I.o-own-stative
•áǫhęˀ	‘it is alone’	[a-ǫhęˀ]	it.o-alone.stative
•gáǫhęˀ	‘she is alone’	[ga-ǫhęˀ]	she.o-alone.stative
•gonǫ́:hęˀ	‘they are alone’	[gon-ǫ́:hęˀ]	they.fe/males-alone.stative
•gó:węh	‘she owns it’	[gó:-w-ęh]	she.o-own-stative
•goná:węh	‘they (fe/males) own it’	[gon-á:w-ęh]	they(fe/males).o-own-stative
•háǫhęˀ	‘he is alone’	[ha-ǫhęˀ]	he.o-alone.stative
•honá:węh	‘they (males) own it’	[hon-á:w-ęh]	they(males).o-own-stative
•honǫ́:hęˀ	‘they (males) are alone’	[hon-ǫ́:hęˀ]	they.males-alone.stative
•hó:węh	‘he owns it’	[hó:-w-ęh]	he.o-own-stative
•oná:węh	‘they (animals) own it’	[on-á:w-ęh]	they(animals).o-own-stative
•onǫ́:hęˀ	‘they (animals) are alone’	[on-ǫ́:hęˀ]	they(animals).o-alone.stative
•ó:węh	‘it owns it’	[ó:-w-ęh]	it.o-own-stative
•sá:węh	‘you own it’	[s-á:w-ęh]	you.o-own-stative
•gó:węh	‘she owns it’	[gó:-w-ęh]	she.o-own-stative
ge̲ˀdreˀ	‘I am dragging it’	[ge̲-ˀdre-ˀ]	I.a-drag-habitual
ęgéˀdre:ˀ	‘I will drag it’	[ę-gé-ˀdre:-ˀ]	future-I.a-drag-punctual
agéˀdre:ˀ	‘I dragged it’	[a-gé-ˀdre:-ˀ]	factual-I.a-drag-punctual
agéˀdrǫ:	‘I dragged it’; ‘I am dragging it’	[agé-ˀdr-ǫ:]	I.o-drag-stative
sa̲ˀdreh	‘you are driving’	[sa̲-ˀdre-h]	you(one).o-drive-habitual
dędíhsa̲ˀdre:ˀ	‘you will drive over here’	[dędí-hsa̲-ˀdre:-ˀ]	dualic.future.cislocative-you(one).o-drive-punctual
ędyagodíˀdre:ˀ	‘they (f/m) will come by vehicle’	[ę-d-yagodí-ˀdre:-ˀ]	future-cislocative-they(fe/males).o-drive-punctual
agéˀdreˀ	‘I am riding along’	[agé-ˀdre-ˀ]	I.o-ride.along-stative
desáˀdre:	‘drive over here’	[de-sá-ˀdre:-ø]	dualic-you(one).o-drive-ø.aspect
•ní:yǫ:	‘a certain amount’	[ní:-y-ǫ:]	partitive-it.o-a.certain.number.stative
•niyǫ́:hah	‘few;’ ‘a little bit’	[ni-y-ǫ́:-hah]	partitive-it.o-a.certain.number.stative-diminutive
•haˀdé:yǫ:	‘many different things’	[haˀ-dé:-y-ǫ:]	translocative-dualic-it.o-a.certain.number.stative
•degaˀahdrá:ge:	‘two baskets’	[de-ga-ˀahdr-á:ge:]	dualic-it.a-basket-two.or.more.stative
•deyohǫnáˀdage:	‘two potatoes’	[de-yo-hǫnáˀd-age:]	dualic-it.o-potato-two.or.more.stative
•nigana̲ˀjá:ge:	‘an amount of pails’; ‘a number of pails’	[ni-ga-na̲ˀj-á:ge:]	partitive-it.a-pail-two.or.more.stative
nigahǫnáˀdage:	‘three potatoes’	[ni-yo-hǫnáˀd-age:], [ni-ga-hǫnáˀd-age:]	partitive-it.o/it.a-potato-two.or.more.stative
•degaˀdre̲hdage̲há:gyeˀ	‘two cars at at time’	[de-ga-ˀdre̲hd-age̲-h-á:-gy-e-ˀ]	dualic-it.a-car-two.or.more.stative-pronunciation.h-progressive-go-stative
•sganǫ́hsa:t	‘one house’	[s-ga-nǫ́hs-a:-t]	repetitive-it.a-house-joinerA-stand.stative
•ganǫ́hsaˀ	‘house’	[ga-nǫ́hs-aˀ]	it.a-house-nsf
niwęˀni̲hsgáǫt	‘it has three wheels’	[ahsę́h] three [ni-w-ęˀni̲hsg-á-ǫt]	partitive-it.a-wheel-joinerA-attached.stative
•degadiyáhshe:	‘two living things’	[de-gadi-yáhshe:]	dualic-they(animals)-two.living.things.stative
•de̲hadiyáhshe:	‘two males’	[de̲-hadi-yahshe:]	dualic-they(males)-two.living.things.stative
•otgáˀdeˀ	‘often’; ‘many’; ‘lots’	[o-t-gáˀdeˀ]	it.o-semireflexive-many.stative
•odeˀdre̲hdága̲ˀdeˀ	‘a lot of cars’	[o-d-e-ˀdre̲hd-á-ga̲ˀdeˀ]	it.o-semireflexive-joinerE-car-many.stative
ga̲ˀdréhdaˀ	‘car’	[ga̲-ˀdréhd-aˀ]	it.a-car-nsf
•onátga̲ˀdeˀ	‘lots of, many’	[on-át-ga̲ˀdeˀ]	they(things)-semireflexive-many.stative
•de̲ˀode̲ˀdrehdagáˀdeˀ	‘not many cars’	[de̲ˀ-o-d-e̲-ˀdrehd-a-gáˀdeˀ]	negative-it.o-semireflexive-joinerE-car-joinerA-many.stative
•aknyǫhsagáˀdeˀ	‘I have a lot of squash’	[ak-hnyǫhs-a-gáˀdeˀ]	I.o-squash-joinerA-many.stative
•agéga̲ˀdeˀ	‘I have many’	[agé-ga̲ˀdeˀ]	I.o-many.stative
•wa̲hshę:	'ten'	[w-ahsh-ę:]	it.a-count.stative
dewáhshę:	'two tens'	[de-w-áhsh-ę:]	dualic-it.a-count.stative
niwáhshę:	'some tens'	[ni-w-áhsh-ę:]	partitive-it.a-count.stative
sga̲heˀ	‘one thing is set on it’	[s-ga̲-heˀ]	repetitive-it.a-set.up.on.top.of.something.stative
gyogyę́hdǫh	'first'	[g-yo-gyę́:hd-ǫh]	cislocative-it.o-start.with-stative
wadǫ́ˀtaˀ	'second'	[w-ad-ǫ́-ˀt-ha]	it.a-semireflexive-resemble-causative-habitual
hesgá:gǫ:t	'last'	[hes-gá:-gǫ:t]	translocative.repetitive-it.a-persevere.stative
hęwá:dra:s	‘times’	[h-ę-w-adraˀ-hsd]	cislocative-future-it.a-meet-causative.ø.punctual
gwęni̲hshǫ́:ˀǫh	‘change’	[gwęni̲hs-sǫ́:ˀǫh]	penny-pluralizer
sgagwéni̲ˀda:t	‘1¢; one penny; one cent’	[s-ga-gwéni̲-ˀd-a:-t]	repetitive-it.a-penny-nominalizer-joinerA-stand.stative
niyogwęníˀdage:	‘5¢; five pennies’	[ni-yo-gwęníˀd-age:]	partitive-it.o-penny-three.or.more.stative
hwíhsgwę́:nihs	‘5¢; a nickel’	[hwíhs-gwę́:nihs]	five-penny
wa̲hshę́:gwę́:nihs	‘10¢; a dime’	[wa̲hshę́:-gwę́:nihs]	ten-penny
hwíhsga̲héˀgwę́:nihs	‘15¢; 15 cents’	[hwíhs-sga̲héˀ-gwę́:nihs]	five-teen-penny
dewahshę́:gwę́:nihs	‘20¢; twenty cents’	[dewahshę́:-gwę́:nihs]	twenty-penny
degahsiǫ́ˀtrage:	‘25¢; twenty-five cents’; ‘a quarter’	[de-ga-hsiǫ́ˀtr-age:]	dualic-it.a-bit-three.or.more.stative
nigahsiǫ́ˀtrage:	‘50¢; fifty cents’	[ni-ga-hsiǫ́ˀtr-age:]	partitive-it.a-bit-three.or.more.stative
ohwíhsdaˀ	‘money’	[o-hwíhsd-aˀ]	it.o-money-nsf
sga̲hwíhsda:t	‘$1; one dollar’	[s-ga̲-hwíhsd-a:-t]	repetitive-it.a-money-joinerA-stand.stative
degahwi̲hsdá:ge:	‘$2; two dollars’	[de-ga-hwi̲hsd-á:ge:]	dualic-it.a-money-three.or.more.stative
nigahwi̲hsdá:ge:	‘$3; three dollars’	[ni-ga-hwi̲hsd-á:ge:]	partitive-it.a-money-three.or.more.stative
gi̲hę:k	‘river, stream, creek’	[Ø-gi̲hę:-k]	missing.prefix-river-verb
nigihú:ˀuh	‘small stream’	[ni-Ø-gih-ú:ˀuh]	partitive-missing.prefix-river-small.stative
gi̲hę́:deˀ	‘creek, river, stream’; ‘it is a river’	[Ø-gi̲hę:-deˀ]	missing.prefix-river-exist.stative
sga:t	‘one’	[s-ga:-t]	repetitive-it.a-stand.stative
dekni:	‘two’	[de-kni-]	dualic-we.two(inclusive)
ahékǫnyęˀ	‘I cooked a meal for him’	[a-he-kǫny-ę-ˀ]	factual-I:him-cook-benefactive-punctual
ęsgwá:yǫˀ	‘you all will give it to me’	[ę-sgwa-yǫ-ˀ]	future-you.all:me-give-punctual
ahsagokwáhkwaˀ	‘he grabbed the food from her’, ‘he took the food from her’	[a-hsago-kwá-hkwa-ˀ]	factual-he:her-food-take.from-punctual
ęhsáhdǫˀ	'you will disappear'	[ę-hs-áhdǫ-ˀ]	future-you(one).o-lose-punctual
esáhdǫ:ˀ	'you lost it'	[e-sá-hdǫ-:-ˀ]	factual-you(one).o-lose-causative-punctual
esahwi̲hsdáhdǫ:ˀ	'you lost money'	[e-sa-hwi̲hsd-áhdǫ-:-ˀ]	factual-you(one).o-money-lose-causative-punctual
tsaˀdę́hsyę:ˀ	'you will put, lay them side-by-side'	[tsaˀd-ę́-hs-yę-:-ˀ]	coincident.factual.dualic-future-you(one).a-lay-causative-punctual
nigá:yęˀ	'where it is at, where it is placed'	[ni-gá:-yę-ˀ]	partitive-it.a-lie-stative
honátge̲hǫˀ	'they (m) are selling something'	[hon-át-ge̲hǫ-ˀ]	they(males).o-semireflexive-sell-habitual
haˀgeˀ	'I am going there'	[h-aˀ-g-e-ˀ]	translocative-factual-I.a-go-punctual
haˀge:ˀ	'I went there'	[h-aˀ-g-e-:-ˀ]	translocative-factual-I.a-go-purposive-punctual
hadíhsreˀ	'they (m) follow'	[hadí-hsre-ˀ]	they(males).a-follow-stative
ęséhsre:ˀ	'you will chase or follow'	[ę-s-é-hsre-:-ˀ]	future-you(one).a-joinerE-chase-purposive-punctual
agéhse:ˀ	'I rode, I came riding'	[ag-é-hs-e-:-ˀ]	I.o-joinerE-lower.back-go-purposive-stative
gegyeˀ	'I am flying'	[g-e-gye-ˀ]	I.a-joinerE-fly-stative
gegye:ˀ	'I came flying'	[g-e-gye-:-ˀ]	I.a-joinerE-fly-purposive-stative
adrihwa̲hséhdǫ:ˀ	'a secret'	[ad-rihw-a̲hséhd-ǫ-:-ˀ]	semireflexive-matter-hide-stative-nominalizer-nsf
odrihwa̲hséhdǫh	'it is secret'	[o-d-rihw-a̲hséhd-ǫh]	it.o-semireflexive-matter-hide-stative
adówadǫ:ˀ	'the hunt'	[adówad-ǫ-:-ˀ]	hunt-stative-nominalizer-nsf
agadowá:dǫh	'I have hunted, am hunting'	[ag-adowá:d-ǫh]	I.o-hunt-stative
agade̲hsrǫ́ni̲hsˀǫh	'I am ready'	[ag-ad-e̲-hsr-ǫ́ni̲-hsˀ-ǫh]	I.o-semireflexive-joinerE-tool-make-eventuative-stative
agade̲hsrǫ́ni̲hsˀǫh	'I am ready'	[ag-ad-e̲-hsr-ǫ́ni̲-hsˀ-ǫh]	I.o-semireflexive-joinerE-tool-make-finish-stative
swatgénihsˀahs	'you have meetings all the time'	[sw-at-géni-hsˀ-a-hs]	you(all).a-semireflexive-compete-finish-joinerA-habitual
ęhswatgeníhsˀa:ˀ	'you all will have a meeting'	[ę-hsw-at-gení-hsˀ-a:ˀ]	future-you(all).a-semireflexive-compete-finish-punctual
swatgénihsˀǫh	'you are having a meeting right now'	[sw-at-géni-hsˀ-ǫh]	you(all).o-semireflexive-compete-finish-stative
haíhwi̲hsˀahs	‘he is making promises, making agreements’	[ha-íhw-i̲hsˀ-a-hs]	he.a-matter-finish-joinerA-habitual
ęgríhwihsˀa:ˀ	‘I will promise’	[ę-g-ríhw-ihsˀ-a:ˀ]	future-I.a-matter-finish-punctual
ęgatędíhsˀa:ˀ	‘I will finish gardening, finish the field’	[ę-g-at-hęd-íhsˀ-a:ˀ]	future-I.a-semireflexive-field-finish-punctual
agataháhsˀa:ˀ	‘I finished a road’	[a-g-at-hah-á-hsˀ-a:ˀ]	factual-I.a-semireflexive-road-joinerA-finish-punctual
ęyǫgya̲ˀdíhsa:ˀ	‘she has matured, completed her life cycle’	[ę-yǫ-g-ya̲ˀd-íhs-a:ˀ]	future-she.a-semireflexive-body-finish-punctual
ędwadri̲hwáhsˀa:ˀ	‘we all will plan something’	[ę-dw-ad-ri̲hw-á-hsˀ-a:ˀ]	future-we.all.inclusive.a-semireflexive-matter-joinerA-finish-punctual
hęgéhsˀaht	‘I will use up’	[h-ę-g-é-hsˀ-a-ht-ø]	translocative-future-I.a-joinerE-finish-joinerA-causative-ø.punctual
awá:tsˀa:ˀ	'it is worn out, all gone, burnt up’; ‘it went down to nothing'	[a-w-á:t-hsˀ-a:ˀ]	factual-it.a-semireflexive-use.up-punctual
haˀwádatsˀǫh	'it is empty, burnt up, used up'	[haˀ-w-ádat-hsˀ-ǫh]	translocative-it.a-reflexive-use.
desádętsˀahs	'your salary’, ‘what you make'	[de-s-ádęt-hsˀ-a-hs]	dualic-you(one).a-reflexive-noun-finish-joinerA-habitual
dęhsádętsˀa:ˀ	'you will earn it (money)'	[d-ę-hs-ádęt-hsˀ-a:ˀ]	dual-future-you(one).a-reflexive-noun-finish-punctual
desádętsˀǫh	'you've earned or deserve it’; ‘you've paid your dues'	[de-s-ádęt-hsˀ-ǫh]	dualic-you(one).o-reflexive-noun-finish-stative
dęhsádatsˀa:ˀ	‘you will quarrel’	[d-ę-hs-ádat-hsˀ-a:ˀ]	dualic-future-you(one).a-reflexive-finish-punctual
watsíhsˀahs	'it is ripening, maturing'	[w-at-hs-íhsˀ-a-hs]	it.a-semireflexive-noun-finish-joinerA-habitual
ęwátsihsˀa:ˀ	'it will mature, ripen'	[ę-w-át-hs-ihsˀ-a:ˀ]	future-it.a-semireflexive-noun-finish-punctual
otsíhsˀǫh	'(it is) done for the season’; ‘it has gone full cycle’; ‘it is mature’; ‘they (plants) have finished out'	[o-t-hs-íhsˀ-ǫh]	it.o-semireflexive-noun-finish-stative
haˀwá:tsˀaht	'it is all gone'	[h-aˀ-w-á:t.hsˀ-a-ht-ø]	translocative-factual-it.a-use.up-cause-ø.punctual
haˀwatnegá:tsˀaht	'water is all gone'	[h-aˀ-w-at-hneg-á:t.hsˀ-a-ht-ø]	translocative-factual-it.a-semireflexive-water-semireflexive.finish-joinerA-causative-ø.punctual
heyótsˀahdǫh	'it is all gone'	[he-yó-t-hsˀ-a-hd-ǫh]	translocative-it.o-semireflexive-finish-joinerA-causative-stative
gadó:wa:s	‘I ama hunter’	[g-ad-ó:wa:d-s]	I.a-semireflexive-hunt-habitual
ęga:dó:wa:t	‘I will hunt’	[ę-g-a:d-ó:wa:t-ø]	future-I.a-semireflexive-hunt-ø.punctual
agadowá:dǫh	‘I am hunting’	[ag-ad-owá:d-ǫh]	I.o-semireflexive-hunt-stative
degáˀswe:s	‘I amgoing deaf’	[de-g-áˀswe:g-s]	dualic-I.a-deaf-habitual
dęgáˀswe:k	‘I will go deaf’	[d-ę-g-áˀswe:k-ø]	dualic-future-I.a-deaf-ø.punctual
dewaga̲ˀswé:gǫh	‘I went deaf’	[de-wag-a̲ˀswé:g-ǫh]	dualic-I.o-deaf-stative
gadǫtgadǫ́haˀ	‘I amfun-loving’	[g-ad-ǫtgadǫ́-haˀ]	I.a-semireflexive-have.fun-habitual
ęhswadǫtgá:dǫ:ˀ	‘you all will have a good time’	[ę-hsw-ad-ǫtgá:dǫ-:ˀ]	future-you(all).a-semireflexive-have.fun-punctual
ǫgwadǫtgá:dǫˀ	‘we all are having fun’	[ǫgw-ad-ǫtgá:dǫ-ˀ]	we.all.o-semireflexive-have.fun-stative
hęnáˀswa̲hthaˀ	‘they (males) are firemen’	[hęn-áˀswa̲ht-haˀ]	they(males).a-extinguish-habitual
ęgáˀswaht	‘I will extinguish it’	[ę-g-áˀswah-t-ø]	future-I.a-extinguish-ø.punctual
agáˀswa̲hdǫh	‘I am extinguishing it’	[ag-áˀswa̲hd-ǫh]	I.o-extinguish-stative
degadawę́:nyehs	‘I wander about all the time’; ‘I ama wanderer’	[de-g-ad-awę́:nye-hs]	dualic-I.a-semireflexive-stir-habitual
dęgadawę́:nye:ˀ	‘I will wander, travel, walk about’	[d-ę-g-ad-awę́:nye-:ˀ]	dualic-future-I.a-semireflexive-stir-punctual
deyagodáwęnyeˀ	‘she is walking about’	[de-yago-d-áwęnye-ˀ]	dualic-she.o-semireflexive-stir-stative
degéˀnyǫgri:	‘my nose is stuffed up’	[de-g-é-ˀnyǫ-gri-:]	dualic-I.a-joinerE-nose-wrinkle-stative
